date,cat1,cat2,cat3,cat4,sum
1/8/15 0:00,0,156,5,7,168
1/8/15 1:00,0,118,4,4,126
1/8/15 2:00,0,115,7,6,128
1/8/15 3:00,0,102,6,7,115
1/8/15 4:00,0,95,13,1,109
1/8/15 5:00,2,151,13,4,170
1/8/15 6:00,6,194,11,4,215
1/8/15 7:00,4,358,18,6,386
1/8/15 8:00,4,412,14,11,441
1/8/15 9:00,5,612,19,9,645
1/8/15 10:00,6,782,23,13,824
1/8/15 11:00,9,890,8,5,912
1/8/15 12:00,7,989,15,12,1023
1/8/15 13:00,8,902,20,12,942
1/8/15 14:00,21,862,12,11,906
1/8/15 15:00,7,686,8,9,710
1/8/15 16:00,2,626,15,15,658
1/8/15 17:00,8,604,18,6,636
1/8/15 18:00,7,542,15,10,574
1/8/15 19:00,2,560,14,4,580
1/8/15 20:00,6,491,13,1,511
1/8/15 21:00,5,325,13,7,350
1/8/15 22:00,8,245,6,4,263
1/8/15 23:00,0,214,7,6,227
2/8/15 0:00,1,190,9,7,207
2/8/15 1:00,1,140,10,5,156
2/8/15 2:00,0,96,5,1,102
2/8/15 3:00,0,111,4,2,117
2/8/15 4:00,0,106,8,1,115
2/8/15 5:00,0,136,5,6,147
2/8/15 6:00,4,190,5,8,207
2/8/15 7:00,1,293,13,10,317
2/8/15 8:00,3,495,15,10,523
2/8/15 9:00,19,728,16,6,769
2/8/15 10:00,12,727,16,11,766
2/8/15 11:00,3,798,13,14,828
2/8/15 12:00,6,943,7,12,968
2/8/15 13:00,7,812,15,15,849
2/8/15 14:00,13,698,15,16,742
2/8/15 15:00,23,724,10,13,770
2/8/15 16:00,6,733,13,17,769
2/8/15 17:00,3,657,17,24,701
2/8/15 18:00,7,754,12,14,787
2/8/15 19:00,9,797,11,10,827
2/8/15 20:00,3,665,16,12,696
2/8/15 21:00,3,477,15,11,506
2/8/15 22:00,1,304,8,4,317
2/8/15 23:00,3,237,10,15,265
3/8/15 0:00,0,191,16,10,217
3/8/15 1:00,4,210,12,10,236
3/8/15 2:00,0,104,9,6,119
3/8/15 3:00,0,111,9,3,123
3/8/15 4:00,1,121,9,4,135
3/8/15 5:00,2,158,7,9,176
3/8/15 6:00,4,259,15,17,295
3/8/15 7:00,3,340,13,4,360
3/8/15 8:00,5,440,11,15,471
3/8/15 9:00,3,539,20,12,574
3/8/15 10:00,7,667,23,15,712
3/8/15 11:00,10,745,19,24,798
3/8/15 12:00,11,760,11,22,804
3/8/15 13:00,7,768,20,14,809
3/8/15 14:00,3,670,21,17,711
3/8/15 15:00,9,595,12,14,630
3/8/15 16:00,6,594,16,15,631
3/8/15 17:00,2,544,19,10,575
3/8/15 18:00,4,403,23,17,447
3/8/15 19:00,4,351,17,10,382
3/8/15 20:00,4,306,7,15,332
3/8/15 21:00,6,239,12,4,261
3/8/15 22:00,0,190,12,7,209
3/8/15 23:00,1,130,9,13,153
4/8/15 0:00,0,104,6,8,118
4/8/15 1:00,0,81,15,7,103
4/8/15 2:00,0,59,9,3,71
4/8/15 3:00,0,64,10,5,79
4/8/15 4:00,0,69,5,12,86
4/8/15 5:00,0,64,13,9,86
4/8/15 6:00,1,148,19,11,179
4/8/15 7:00,0,245,18,14,277
4/8/15 8:00,4,320,12,10,346
4/8/15 9:00,5,429,19,15,468
4/8/15 10:00,7,456,16,14,493
4/8/15 11:00,2,616,16,28,662
4/8/15 12:00,6,565,17,30,618
4/8/15 13:00,16,516,13,21,566
4/8/15 14:00,2,474,15,16,507
4/8/15 15:00,6,459,20,22,507
4/8/15 16:00,5,421,18,23,467
4/8/15 17:00,9,457,20,15,501
4/8/15 18:00,7,411,17,18,453
4/8/15 19:00,7,475,13,20,515
4/8/15 20:00,2,322,11,9,344
4/8/15 21:00,1,218,10,14,243
4/8/15 22:00,3,232,7,13,255
4/8/15 23:00,3,148,7,12,170
5/8/15 0:00,0,143,6,10,159
5/8/15 1:00,0,83,15,10,108
5/8/15 2:00,0,66,10,6,82
5/8/15 3:00,0,48,8,4,60
5/8/15 4:00,0,64,7,5,76
5/8/15 5:00,0,93,5,12,110
5/8/15 6:00,1,144,21,13,179
5/8/15 7:00,1,253,10,12,276
5/8/15 8:00,2,341,21,18,382
5/8/15 9:00,4,472,21,15,512
5/8/15 10:00,9,642,21,17,689
5/8/15 11:00,6,630,21,27,684
5/8/15 12:00,8,642,26,28,704
5/8/15 13:00,4,563,19,28,614
5/8/15 14:00,4,541,17,25,587
5/8/15 15:00,2,502,26,13,543
5/8/15 16:00,7,466,14,11,498
5/8/15 17:00,3,457,19,20,499
5/8/15 18:00,5,403,15,26,449
5/8/15 19:00,9,429,15,17,470
5/8/15 20:00,4,373,8,12,397
5/8/15 21:00,1,324,10,9,344
5/8/15 22:00,0,216,14,14,244
5/8/15 23:00,0,172,10,9,191
6/8/15 0:00,0,168,11,12,191
6/8/15 1:00,0,99,4,14,117
6/8/15 2:00,1,95,8,4,108
6/8/15 3:00,0,78,10,5,93
6/8/15 4:00,0,85,9,8,102
6/8/15 5:00,0,91,10,12,113
6/8/15 6:00,0,203,13,10,226
6/8/15 7:00,1,339,25,7,372
6/8/15 8:00,4,448,21,12,485
6/8/15 9:00,5,511,24,9,549
6/8/15 10:00,8,610,25,19,662
6/8/15 11:00,3,681,19,26,729
6/8/15 12:00,4,685,21,21,731
6/8/15 13:00,4,632,21,27,684
6/8/15 14:00,5,566,20,27,618
6/8/15 15:00,5,564,25,24,618
6/8/15 16:00,4,547,22,27,600
6/8/15 17:00,2,519,21,18,560
6/8/15 18:00,5,466,21,22,514
6/8/15 19:00,8,425,12,18,463
6/8/15 20:00,3,382,9,15,409
6/8/15 21:00,2,290,20,16,328
6/8/15 22:00,3,253,10,10,276
6/8/15 23:00,1,204,13,20,238
7/8/15 0:00,0,143,9,12,164
7/8/15 1:00,1,134,15,16,166
7/8/15 2:00,2,109,12,6,129
7/8/15 3:00,0,113,9,10,132
7/8/15 4:00,0,96,7,7,110
7/8/15 5:00,0,120,6,6,132
7/8/15 6:00,3,194,21,10,228
7/8/15 7:00,3,329,15,10,357
7/8/15 8:00,5,410,13,8,436
7/8/15 9:00,2,506,15,17,540
7/8/15 10:00,3,599,24,14,640
7/8/15 11:00,9,751,20,16,796
7/8/15 12:00,7,755,23,29,814
7/8/15 13:00,6,726,30,33,795
7/8/15 14:00,9,804,30,31,874
7/8/15 15:00,10,710,29,19,768
7/8/15 16:00,8,672,11,15,706
7/8/15 17:00,7,698,16,12,733
7/8/15 18:00,10,594,26,16,646
7/8/15 19:00,9,594,17,20,640
7/8/15 20:00,4,394,19,4,421
7/8/15 21:00,1,336,16,5,358
7/8/15 22:00,2,290,11,11,314
7/8/15 23:00,2,231,10,7,250
8/8/15 0:00,3,204,3,7,217
8/8/15 1:00,1,145,8,6,160
8/8/15 2:00,0,143,10,3,156
8/8/15 3:00,0,126,10,2,138
8/8/15 4:00,0,98,5,4,107
8/8/15 5:00,1,129,2,5,137
8/8/15 6:00,1,207,11,7,226
8/8/15 7:00,3,323,17,4,347
8/8/15 8:00,9,445,12,13,479
8/8/15 9:00,7,589,13,13,622
8/8/15 10:00,6,775,25,14,820
8/8/15 11:00,7,922,12,16,957
8/8/15 12:00,7,927,18,12,964
8/8/15 13:00,9,878,17,24,928
8/8/15 14:00,9,719,20,12,760
8/8/15 15:00,22,670,10,9,711
8/8/15 16:00,10,720,19,7,756
8/8/15 17:00,6,617,23,14,660
8/8/15 18:00,6,562,18,12,598
8/8/15 19:00,4,455,7,9,475
8/8/15 20:00,7,405,9,8,429
8/8/15 21:00,2,321,11,4,338
8/8/15 22:00,1,262,4,7,274
8/8/15 23:00,1,229,6,5,241
9/8/15 0:00,0,187,10,8,205
9/8/15 1:00,0,157,7,2,166
9/8/15 2:00,0,121,7,5,133
9/8/15 3:00,0,146,11,4,161
9/8/15 4:00,2,102,9,5,118
9/8/15 5:00,2,152,5,4,163
9/8/15 6:00,1,187,10,1,199
9/8/15 7:00,3,329,14,5,351
9/8/15 8:00,11,566,15,7,599
9/8/15 9:00,10,654,10,8,682
9/8/15 10:00,11,882,20,11,924
9/8/15 11:00,11,905,16,13,945
9/8/15 12:00,14,897,20,16,947
9/8/15 13:00,12,758,22,9,801
9/8/15 14:00,5,670,18,20,713
9/8/15 15:00,9,603,11,21,644
9/8/15 16:00,7,634,16,14,671
9/8/15 17:00,5,571,19,11,606
9/8/15 18:00,11,668,15,8,702
9/8/15 19:00,12,716,18,8,754
9/8/15 20:00,10,593,11,15,629
9/8/15 21:00,1,410,12,17,440
9/8/15 22:00,5,326,9,9,349
9/8/15 23:00,1,220,10,9,240
10/8/15 0:00,2,261,12,11,286
10/8/15 1:00,1,131,11,6,149
10/8/15 2:00,0,73,10,6,89
10/8/15 3:00,0,80,7,3,90
10/8/15 4:00,1,96,12,3,112
10/8/15 5:00,0,111,7,12,130
10/8/15 6:00,5,238,17,11,271
10/8/15 7:00,2,296,22,10,330
10/8/15 8:00,4,369,12,10,395
10/8/15 9:00,4,508,23,11,546
10/8/15 10:00,4,661,24,17,706
10/8/15 11:00,15,776,18,19,828
10/8/15 12:00,13,860,12,20,905
10/8/15 13:00,15,721,17,12,765
10/8/15 14:00,11,632,13,14,670
10/8/15 15:00,3,474,17,16,510
10/8/15 16:00,5,518,26,14,563
10/8/15 17:00,2,514,22,15,553
10/8/15 18:00,3,454,15,23,495
10/8/15 19:00,11,413,22,19,465
10/8/15 20:00,5,379,9,8,401
10/8/15 21:00,5,247,12,6,270
10/8/15 22:00,4,191,5,11,211
10/8/15 23:00,0,149,7,10,166
11/8/15 0:00,0,98,8,6,112
11/8/15 1:00,0,72,11,2,85
11/8/15 2:00,0,62,6,7,75
11/8/15 3:00,0,57,11,8,76
11/8/15 4:00,0,53,13,4,70
11/8/15 5:00,0,64,5,13,82
11/8/15 6:00,0,112,14,8,134
11/8/15 7:00,1,236,21,10,268
11/8/15 8:00,2,330,18,11,361
11/8/15 9:00,5,448,13,9,475
11/8/15 10:00,7,567,18,11,603
11/8/15 11:00,10,642,12,17,681
11/8/15 12:00,5,676,17,27,725
11/8/15 13:00,7,549,20,25,601
11/8/15 14:00,3,468,21,20,512
11/8/15 15:00,10,472,13,11,506
11/8/15 16:00,3,459,19,10,491
11/8/15 17:00,4,479,23,16,522
11/8/15 18:00,11,448,27,21,507
11/8/15 19:00,8,550,17,12,587
11/8/15 20:00,6,344,13,8,371
11/8/15 21:00,3,236,14,9,262
11/8/15 22:00,3,205,7,7,222
11/8/15 23:00,6,145,12,8,171
12/8/15 0:00,0,102,5,5,112
12/8/15 1:00,2,79,11,3,95
12/8/15 2:00,0,52,7,5,64
12/8/15 3:00,0,43,8,5,56
12/8/15 4:00,0,58,10,7,75
12/8/15 5:00,1,86,10,8,105
12/8/15 6:00,2,121,21,12,156
12/8/15 7:00,5,249,15,13,282
12/8/15 8:00,4,357,18,12,391
12/8/15 9:00,6,467,17,9,499
12/8/15 10:00,9,647,18,14,688
12/8/15 11:00,10,696,22,13,741
12/8/15 12:00,8,690,17,22,737
12/8/15 13:00,5,554,17,9,585
12/8/15 14:00,16,579,25,21,641
12/8/15 15:00,6,481,14,12,513
12/8/15 16:00,5,489,17,12,523
12/8/15 17:00,1,457,21,15,494
12/8/15 18:00,7,485,23,16,531
12/8/15 19:00,10,412,10,9,441
12/8/15 20:00,4,347,18,14,383
12/8/15 21:00,3,287,18,8,316
12/8/15 22:00,5,206,12,11,234
12/8/15 23:00,1,147,10,8,166
13/8/15 0:00,1,117,12,10,140
13/8/15 1:00,0,107,13,11,131
13/8/15 2:00,0,73,9,3,85
13/8/15 3:00,0,57,10,7,74
13/8/15 4:00,1,72,4,12,89
13/8/15 5:00,1,89,10,8,108
13/8/15 6:00,2,188,17,10,217
13/8/15 7:00,4,261,15,12,292
13/8/15 8:00,5,381,18,14,418
13/8/15 9:00,3,494,23,15,535
13/8/15 10:00,6,677,17,20,720
13/8/15 11:00,6,754,11,28,799
13/8/15 12:00,10,730,17,19,776
13/8/15 13:00,5,665,18,29,717
13/8/15 14:00,10,633,25,17,685
13/8/15 15:00,5,520,16,18,559
13/8/15 16:00,3,576,25,10,614
13/8/15 17:00,4,523,32,11,570
13/8/15 18:00,8,518,17,19,562
13/8/15 19:00,4,500,17,13,534
13/8/15 20:00,8,381,12,8,409
13/8/15 21:00,5,335,15,15,370
13/8/15 22:00,2,270,11,11,294
13/8/15 23:00,2,180,6,13,201
14/8/15 0:00,1,154,10,3,168
14/8/15 1:00,0,131,16,7,154
14/8/15 2:00,0,106,4,0,110
14/8/15 3:00,1,109,8,6,124
14/8/15 4:00,0,75,10,6,91
14/8/15 5:00,2,113,5,8,128
14/8/15 6:00,1,167,16,11,195
14/8/15 7:00,4,324,12,5,345
14/8/15 8:00,4,384,9,10,407
14/8/15 9:00,6,521,19,12,558
14/8/15 10:00,4,749,11,21,785
14/8/15 11:00,9,842,10,14,875
14/8/15 12:00,23,852,18,18,911
14/8/15 13:00,19,784,21,14,838
14/8/15 14:00,16,887,20,16,939
14/8/15 15:00,7,753,16,14,790
14/8/15 16:00,18,785,20,13,836
14/8/15 17:00,9,772,15,10,806
14/8/15 18:00,12,704,17,10,743
14/8/15 19:00,7,626,22,4,659
14/8/15 20:00,4,479,8,6,497
14/8/15 21:00,2,380,10,2,394
14/8/15 22:00,4,353,9,6,372
14/8/15 23:00,2,217,6,1,226
15/8/15 0:00,1,178,8,5,192
15/8/15 1:00,1,125,5,4,135
15/8/15 2:00,1,68,3,3,75
15/8/15 3:00,0,95,10,3,108
15/8/15 4:00,1,86,4,1,92
15/8/15 5:00,0,132,5,3,140
15/8/15 6:00,1,165,5,3,174
15/8/15 7:00,2,300,8,5,315
15/8/15 8:00,7,391,9,8,415
15/8/15 9:00,16,521,11,2,550
15/8/15 10:00,6,695,7,5,713
15/8/15 11:00,12,777,8,16,813
15/8/15 12:00,15,858,6,10,889
15/8/15 13:00,11,729,9,11,760
15/8/15 14:00,13,585,10,10,618
15/8/15 15:00,5,485,12,10,512
15/8/15 16:00,7,456,15,10,488
15/8/15 17:00,5,505,16,7,533
15/8/15 18:00,3,419,12,8,442
15/8/15 19:00,6,403,5,4,418
15/8/15 20:00,8,360,7,2,377
15/8/15 21:00,5,276,6,2,289
15/8/15 22:00,3,240,4,2,249
15/8/15 23:00,4,179,4,2,189
16/8/15 0:00,2,142,5,7,156
16/8/15 1:00,1,117,7,0,125
16/8/15 2:00,0,88,7,2,97
16/8/15 3:00,0,65,12,7,84
16/8/15 4:00,0,82,10,2,94
16/8/15 5:00,3,122,12,3,140
16/8/15 6:00,1,166,3,4,174
16/8/15 7:00,4,321,11,5,341
16/8/15 8:00,14,566,7,3,590
16/8/15 9:00,17,842,17,7,883
16/8/15 10:00,16,868,19,8,911
16/8/15 11:00,10,1062,14,15,1101
16/8/15 12:00,12,1068,16,10,1106
16/8/15 13:00,17,952,16,7,992
16/8/15 14:00,5,844,19,15,883
16/8/15 15:00,5,824,11,18,858
16/8/15 16:00,5,738,14,7,764
16/8/15 17:00,11,901,22,8,942
16/8/15 18:00,12,837,18,12,879
16/8/15 19:00,15,886,18,7,926
16/8/15 20:00,12,766,15,5,798
16/8/15 21:00,5,515,14,11,545
16/8/15 22:00,5,336,10,8,359
16/8/15 23:00,0,235,13,6,254
17/8/15 0:00,1,301,8,6,316
17/8/15 1:00,1,167,10,4,182
17/8/15 2:00,0,87,15,2,104
17/8/15 3:00,0,70,4,4,78
17/8/15 4:00,1,79,7,4,91
17/8/15 5:00,1,102,8,10,121
17/8/15 6:00,1,218,11,5,235
17/8/15 7:00,4,378,17,5,404
17/8/15 8:00,4,435,10,7,456
17/8/15 9:00,7,616,21,11,655
17/8/15 10:00,13,806,18,17,854
17/8/15 11:00,16,930,10,16,972
17/8/15 12:00,15,976,17,18,1026
17/8/15 13:00,7,845,16,26,894
17/8/15 14:00,10,751,10,11,782
17/8/15 15:00,12,617,20,12,661
17/8/15 16:00,17,644,16,11,688
17/8/15 17:00,12,608,17,16,653
17/8/15 18:00,8,518,16,5,547
17/8/15 19:00,5,498,11,12,526
17/8/15 20:00,5,422,10,4,441
17/8/15 21:00,6,301,9,8,324
17/8/15 22:00,2,221,9,10,242
17/8/15 23:00,0,128,6,17,151
18/8/15 0:00,1,154,11,3,169
18/8/15 1:00,1,95,14,12,122
18/8/15 2:00,0,65,10,3,78
18/8/15 3:00,1,64,3,8,76
18/8/15 4:00,0,59,7,5,71
18/8/15 5:00,0,70,12,4,86
18/8/15 6:00,2,153,13,8,176
18/8/15 7:00,2,248,10,5,265
18/8/15 8:00,3,354,14,5,376
18/8/15 9:00,6,510,11,7,534
18/8/15 10:00,3,595,16,20,634
18/8/15 11:00,12,694,18,9,733
18/8/15 12:00,8,623,13,22,666
18/8/15 13:00,10,555,20,12,597
18/8/15 14:00,7,555,19,21,602
18/8/15 15:00,5,482,12,14,513
18/8/15 16:00,9,483,24,6,522
18/8/15 17:00,6,509,22,6,543
18/8/15 18:00,6,465,15,16,502
18/8/15 19:00,19,634,16,19,688
18/8/15 20:00,3,388,11,11,413
18/8/15 21:00,5,300,27,8,340
18/8/15 22:00,2,210,9,12,233
18/8/15 23:00,0,155,9,18,182
19/8/15 0:00,0,119,8,12,139
19/8/15 1:00,1,88,11,8,108
19/8/15 2:00,1,64,13,2,80
19/8/15 3:00,0,50,7,5,62
19/8/15 4:00,0,44,11,5,60
19/8/15 5:00,0,101,8,1,110
19/8/15 6:00,2,147,12,7,168
19/8/15 7:00,4,187,16,5,212
19/8/15 8:00,4,304,16,8,332
19/8/15 9:00,8,480,16,14,518
19/8/15 10:00,21,801,20,17,859
19/8/15 11:00,5,620,22,17,664
19/8/15 12:00,11,623,23,24,681
19/8/15 13:00,7,574,16,10,607
19/8/15 14:00,12,648,24,12,696
19/8/15 15:00,7,468,19,14,508
19/8/15 16:00,2,491,13,13,519
19/8/15 17:00,9,505,21,21,556
19/8/15 18:00,3,458,15,18,494
19/8/15 19:00,6,392,14,11,423
19/8/15 20:00,3,337,18,10,368
19/8/15 21:00,3,270,9,7,289
19/8/15 22:00,2,219,15,11,247
19/8/15 23:00,0,172,10,9,191
20/8/15 0:00,0,131,8,4,143
20/8/15 1:00,1,87,10,7,105
20/8/15 2:00,0,86,8,4,98
20/8/15 3:00,0,84,7,8,99
20/8/15 4:00,0,72,7,6,85
20/8/15 5:00,1,95,11,7,114
20/8/15 6:00,0,172,15,9,196
20/8/15 7:00,1,296,22,10,329
20/8/15 8:00,4,365,13,12,394
20/8/15 9:00,10,523,20,14,567
20/8/15 10:00,7,625,17,19,668
20/8/15 11:00,5,722,12,17,756
20/8/15 12:00,8,673,23,27,731
20/8/15 13:00,3,679,22,27,731
20/8/15 14:00,7,649,16,21,693
20/8/15 15:00,4,629,32,16,681
20/8/15 16:00,7,663,26,15,711
20/8/15 17:00,4,623,20,21,668
20/8/15 18:00,7,537,16,3,563
20/8/15 19:00,7,440,20,24,491
20/8/15 20:00,3,372,16,14,405
20/8/15 21:00,0,293,11,5,309
20/8/15 22:00,2,259,11,10,282
20/8/15 23:00,3,265,7,12,287
21/8/15 0:00,1,197,15,11,224
21/8/15 1:00,0,127,8,7,142
21/8/15 2:00,0,101,7,4,112
21/8/15 3:00,0,90,12,6,108
21/8/15 4:00,0,95,7,7,109
21/8/15 5:00,0,117,14,3,134
21/8/15 6:00,0,180,18,5,203
21/8/15 7:00,1,288,14,10,313
21/8/15 8:00,1,476,8,11,496
21/8/15 9:00,6,583,19,12,620
21/8/15 10:00,7,710,21,18,756
21/8/15 11:00,7,874,12,15,908
21/8/15 12:00,5,949,23,25,1002
21/8/15 13:00,12,797,25,34,868
21/8/15 14:00,9,817,19,20,865
21/8/15 15:00,4,734,23,19,780
21/8/15 16:00,10,706,15,9,740
21/8/15 17:00,3,701,17,15,736
21/8/15 18:00,8,695,13,8,724
21/8/15 19:00,0,505,18,9,532
21/8/15 20:00,4,434,9,10,457
21/8/15 21:00,3,308,10,7,328
21/8/15 22:00,3,280,9,7,299
21/8/15 23:00,1,189,11,9,210
22/8/15 0:00,1,138,11,3,153
22/8/15 1:00,0,114,8,5,127
22/8/15 2:00,0,78,4,0,82
22/8/15 3:00,0,84,7,2,93
22/8/15 4:00,0,95,10,0,105
22/8/15 5:00,0,115,5,2,122
22/8/15 6:00,9,184,18,6,217
22/8/15 7:00,1,297,16,4,318
22/8/15 8:00,1,391,12,2,406
22/8/15 9:00,4,529,9,13,555
22/8/15 10:00,2,728,22,13,765
22/8/15 11:00,15,851,9,12,887
22/8/15 12:00,13,891,14,15,933
22/8/15 13:00,5,873,14,20,912
22/8/15 14:00,4,715,11,14,744
22/8/15 15:00,11,700,12,16,739
22/8/15 16:00,10,682,13,14,719
22/8/15 17:00,6,735,22,1,764
22/8/15 18:00,7,647,16,9,679
22/8/15 19:00,8,517,12,10,547
22/8/15 20:00,3,372,12,5,392
22/8/15 21:00,0,264,6,7,277
22/8/15 22:00,0,198,4,6,208
22/8/15 23:00,1,163,6,10,180
23/8/15 0:00,0,175,10,5,190
23/8/15 1:00,0,153,5,3,161
23/8/15 2:00,0,117,5,1,123
23/8/15 3:00,0,67,10,3,80
23/8/15 4:00,2,96,5,4,107
23/8/15 5:00,0,85,7,5,97
23/8/15 6:00,0,140,10,5,155
23/8/15 7:00,1,246,18,12,277
23/8/15 8:00,2,404,16,6,428
23/8/15 9:00,17,591,14,8,630
23/8/15 10:00,12,871,24,5,912
23/8/15 11:00,6,804,13,11,834
23/8/15 12:00,3,812,15,10,840
23/8/15 13:00,10,822,17,11,860
23/8/15 14:00,11,849,24,12,896
23/8/15 15:00,1,777,16,12,806
23/8/15 16:00,6,750,16,17,789
23/8/15 17:00,6,789,12,19,826
23/8/15 18:00,5,764,12,9,790
23/8/15 19:00,10,706,10,8,734
23/8/15 20:00,6,549,16,5,576
23/8/15 21:00,1,449,11,13,474
23/8/15 22:00,2,341,12,7,362
23/8/15 23:00,2,224,13,4,243
24/8/15 0:00,1,241,14,8,264
24/8/15 1:00,2,217,13,8,240
24/8/15 2:00,0,103,7,10,120
24/8/15 3:00,0,76,6,10,92
24/8/15 4:00,0,57,10,3,70
24/8/15 5:00,2,103,7,6,118
24/8/15 6:00,2,200,11,8,221
24/8/15 7:00,3,336,25,6,370
24/8/15 8:00,2,406,13,8,429
24/8/15 9:00,5,567,24,16,612
24/8/15 10:00,6,607,14,15,642
24/8/15 11:00,4,707,10,24,745
24/8/15 12:00,8,686,24,23,741
24/8/15 13:00,9,689,18,16,732
24/8/15 14:00,2,608,20,24,654
24/8/15 15:00,3,524,15,15,557
24/8/15 16:00,1,517,18,18,554
24/8/15 17:00,1,509,23,25,558
24/8/15 18:00,4,424,21,9,458
24/8/15 19:00,6,427,12,10,455
24/8/15 20:00,4,332,14,9,359
24/8/15 21:00,4,254,8,13,279
24/8/15 22:00,0,217,11,12,240
24/8/15 23:00,3,154,5,6,168
25/8/15 0:00,0,126,11,11,148
25/8/15 1:00,0,83,11,5,99
25/8/15 2:00,2,57,9,6,74
25/8/15 3:00,0,57,4,1,62
25/8/15 4:00,1,82,10,4,97
25/8/15 5:00,0,87,12,12,111
25/8/15 6:00,0,156,15,10,181
25/8/15 7:00,0,251,16,12,279
25/8/15 8:00,3,357,4,10,374
25/8/15 9:00,10,421,12,15,458
25/8/15 10:00,1,549,20,17,587
25/8/15 11:00,9,626,19,26,680
25/8/15 12:00,3,644,17,23,687
25/8/15 13:00,4,543,17,22,586
25/8/15 14:00,7,503,17,22,549
25/8/15 15:00,4,450,14,17,485
25/8/15 16:00,4,513,21,22,560
25/8/15 17:00,10,473,16,13,512
25/8/15 18:00,6,457,13,11,487
25/8/15 19:00,5,594,18,14,631
25/8/15 20:00,9,334,18,17,378
25/8/15 21:00,2,270,20,12,304
25/8/15 22:00,0,201,7,13,221
25/8/15 23:00,1,165,12,13,191
26/8/15 0:00,0,116,9,11,136
26/8/15 1:00,1,69,7,10,87
26/8/15 2:00,2,59,10,6,77
26/8/15 3:00,0,69,8,6,83
26/8/15 4:00,0,97,10,7,114
26/8/15 5:00,0,99,12,7,118
26/8/15 6:00,0,167,15,11,193
26/8/15 7:00,2,289,18,18,327
26/8/15 8:00,2,424,16,12,454
26/8/15 9:00,8,550,15,26,599
26/8/15 10:00,10,816,27,27,880
26/8/15 11:00,4,697,23,20,744
26/8/15 12:00,9,644,19,31,703
26/8/15 13:00,4,594,27,36,661
26/8/15 14:00,10,712,25,11,758
26/8/15 15:00,5,566,17,18,606
26/8/15 16:00,4,536,24,12,576
26/8/15 17:00,3,517,21,16,557
26/8/15 18:00,7,488,14,22,531
26/8/15 19:00,2,381,20,15,418
26/8/15 20:00,2,320,16,12,350
26/8/15 21:00,0,278,14,17,309
26/8/15 22:00,0,224,14,9,247
26/8/15 23:00,0,153,8,15,176
27/8/15 0:00,1,153,13,15,182
27/8/15 1:00,0,96,14,8,118
27/8/15 2:00,1,104,7,7,119
27/8/15 3:00,1,91,11,5,108
27/8/15 4:00,0,103,9,6,118
27/8/15 5:00,0,130,8,7,145
27/8/15 6:00,0,200,12,14,226
27/8/15 7:00,1,333,24,12,370
27/8/15 8:00,3,519,20,13,555
27/8/15 9:00,8,598,18,13,637
27/8/15 10:00,2,745,18,20,785
27/8/15 11:00,5,700,16,24,745
27/8/15 12:00,7,662,23,24,716
27/8/15 13:00,4,612,21,23,660
27/8/15 14:00,5,617,15,18,655
27/8/15 15:00,6,546,18,24,594
27/8/15 16:00,3,593,24,13,633
27/8/15 17:00,3,637,16,17,673
27/8/15 18:00,5,545,23,25,598
27/8/15 19:00,2,496,22,20,540
27/8/15 20:00,2,391,8,12,413
27/8/15 21:00,4,334,18,15,371
27/8/15 22:00,0,296,12,10,318
27/8/15 23:00,0,194,14,12,220
28/8/15 0:00,2,192,11,9,214
28/8/15 1:00,1,159,12,5,177
28/8/15 2:00,0,113,11,5,129
28/8/15 3:00,0,148,5,11,164
28/8/15 4:00,0,111,10,6,127
28/8/15 5:00,0,147,11,3,161
28/8/15 6:00,2,191,17,14,224
28/8/15 7:00,2,303,16,4,325
28/8/15 8:00,6,532,15,8,561
28/8/15 9:00,6,595,19,13,633
28/8/15 10:00,3,662,19,26,710
28/8/15 11:00,6,806,14,25,851
28/8/15 12:00,9,841,25,31,906
28/8/15 13:00,9,754,18,42,823
28/8/15 14:00,18,760,25,27,830
28/8/15 15:00,8,843,14,23,888
28/8/15 16:00,3,840,18,14,875
28/8/15 17:00,5,811,17,12,845
28/8/15 18:00,14,672,15,19,720
28/8/15 19:00,3,656,16,7,682
28/8/15 20:00,3,529,17,14,563
28/8/15 21:00,1,403,15,12,431
28/8/15 22:00,1,292,14,10,317
28/8/15 23:00,1,190,12,4,207
29/8/15 0:00,0,165,11,12,188
29/8/15 1:00,1,148,7,7,163
29/8/15 2:00,0,111,11,3,125
29/8/15 3:00,1,100,6,0,107
29/8/15 4:00,0,108,10,2,120
29/8/15 5:00,0,135,7,4,146
29/8/15 6:00,0,187,11,9,207
29/8/15 7:00,1,366,15,6,388
29/8/15 8:00,3,454,27,8,492
29/8/15 9:00,9,608,15,6,638
29/8/15 10:00,6,784,13,8,811
29/8/15 11:00,3,893,8,15,919
29/8/15 12:00,10,910,23,12,955
29/8/15 13:00,4,799,15,12,830
29/8/15 14:00,9,679,10,12,710
29/8/15 15:00,10,705,16,12,743
29/8/15 16:00,8,704,21,8,741
29/8/15 17:00,9,717,23,13,762
29/8/15 18:00,7,588,22,15,632
29/8/15 19:00,6,551,13,8,578
29/8/15 20:00,2,403,8,6,419
29/8/15 21:00,3,294,6,4,307
29/8/15 22:00,1,258,6,6,271
29/8/15 23:00,1,180,8,5,194
30/8/15 0:00,3,194,7,11,215
30/8/15 1:00,1,202,8,4,215
30/8/15 2:00,0,97,9,0,106
30/8/15 3:00,1,72,5,5,83
30/8/15 4:00,0,76,10,2,88
30/8/15 5:00,0,89,3,6,98
30/8/15 6:00,0,165,8,4,177
30/8/15 7:00,0,266,7,6,279
30/8/15 8:00,8,432,18,6,464
30/8/15 9:00,10,742,29,8,789
30/8/15 10:00,6,755,32,12,805
30/8/15 11:00,11,856,20,11,898
30/8/15 12:00,9,843,25,16,893
30/8/15 13:00,9,791,22,14,836
30/8/15 14:00,6,764,17,27,814
30/8/15 15:00,11,709,19,21,760
30/8/15 16:00,12,844,20,16,892
30/8/15 17:00,16,808,22,16,862
30/8/15 18:00,3,789,23,18,833
30/8/15 19:00,10,742,17,13,782
30/8/15 20:00,6,615,19,8,648
30/8/15 21:00,2,478,17,18,515
30/8/15 22:00,3,308,12,14,337
30/8/15 23:00,1,244,10,12,267
31/8/15 0:00,3,281,11,8,303
31/8/15 1:00,1,147,17,7,172
31/8/15 2:00,1,95,5,5,106
31/8/15 3:00,0,81,11,5,97
31/8/15 4:00,0,76,6,5,87
31/8/15 5:00,0,114,14,3,131
31/8/15 6:00,1,224,16,15,256
31/8/15 7:00,2,353,21,12,388
31/8/15 8:00,3,412,7,16,438
31/8/15 9:00,6,545,21,13,585
31/8/15 10:00,6,606,23,20,655
31/8/15 11:00,11,695,13,36,755
31/8/15 12:00,5,689,31,24,749
31/8/15 13:00,7,704,14,28,753
31/8/15 14:00,2,644,15,19,680
31/8/15 15:00,5,590,14,25,634
31/8/15 16:00,3,545,28,22,598
31/8/15 17:00,5,492,18,17,532
31/8/15 18:00,2,485,23,27,537
31/8/15 19:00,3,424,21,23,471
31/8/15 20:00,3,372,15,17,407
31/8/15 21:00,1,252,10,10,273
31/8/15 22:00,2,196,11,9,218
31/8/15 23:00,3,131,8,14,156
1/9/15 0:00,2,118,8,11,139
1/9/15 1:00,1,73,15,8,97
1/9/15 2:00,1,69,7,5,82
1/9/15 3:00,0,54,14,4,72
1/9/15 4:00,0,65,6,4,75
1/9/15 5:00,1,90,14,8,113
1/9/15 6:00,2,158,21,14,195
1/9/15 7:00,0,253,18,12,283
1/9/15 8:00,3,433,19,7,462
1/9/15 9:00,1,534,10,17,562
1/9/15 10:00,7,541,19,20,587
1/9/15 11:00,3,527,17,23,570
1/9/15 12:00,4,494,16,31,545
1/9/15 13:00,2,601,19,25,647
1/9/15 14:00,9,512,11,19,551
1/9/15 15:00,1,512,18,24,555
1/9/15 16:00,6,515,20,15,556
1/9/15 17:00,5,518,18,8,549
1/9/15 18:00,6,401,12,23,442
1/9/15 19:00,7,429,24,19,479
1/9/15 20:00,2,418,30,9,459
1/9/15 21:00,1,203,14,14,232
1/9/15 22:00,2,180,15,17,214
1/9/15 23:00,2,114,19,16,151
2/9/15 0:00,5,123,14,7,149
2/9/15 1:00,1,83,19,4,107
2/9/15 2:00,0,55,15,5,75
2/9/15 3:00,0,58,9,4,71
2/9/15 4:00,0,61,7,5,73
2/9/15 5:00,0,66,9,9,84
2/9/15 6:00,0,141,15,9,165
2/9/15 7:00,2,244,18,17,281
2/9/15 8:00,0,346,19,15,380
2/9/15 9:00,3,466,23,13,505
2/9/15 10:00,13,656,38,17,724
2/9/15 11:00,7,523,33,24,587
2/9/15 12:00,4,455,18,44,521
2/9/15 13:00,5,457,17,27,506
2/9/15 14:00,0,535,28,22,585
2/9/15 15:00,3,472,16,17,508
2/9/15 16:00,4,447,24,14,489
2/9/15 17:00,1,443,9,20,473
2/9/15 18:00,5,331,17,21,374
2/9/15 19:00,1,331,22,18,372
2/9/15 20:00,2,288,9,19,318
2/9/15 21:00,1,216,13,16,246
2/9/15 22:00,3,189,13,13,218
2/9/15 23:00,1,138,5,14,158
3/9/15 0:00,0,119,15,8,142
3/9/15 1:00,0,83,8,7,98
3/9/15 2:00,0,74,13,7,94
3/9/15 3:00,0,67,9,4,80
3/9/15 4:00,1,61,11,8,81
3/9/15 5:00,1,98,8,9,116
3/9/15 6:00,1,139,21,12,173
3/9/15 7:00,0,253,25,10,288
3/9/15 8:00,0,384,25,13,422
3/9/15 9:00,0,465,15,18,498
3/9/15 10:00,3,512,23,22,560
3/9/15 11:00,5,556,20,33,614
3/9/15 12:00,9,544,16,21,590
3/9/15 13:00,3,479,21,26,529
3/9/15 14:00,4,512,14,19,549
3/9/15 15:00,11,466,21,27,525
3/9/15 16:00,3,475,18,15,511
3/9/15 17:00,3,436,26,17,482
3/9/15 18:00,7,410,21,16,454
3/9/15 19:00,2,391,20,21,434
3/9/15 20:00,6,302,9,21,338
3/9/15 21:00,4,253,20,13,290
3/9/15 22:00,0,229,19,24,272
3/9/15 23:00,0,132,11,19,162
4/9/15 0:00,0,128,12,7,147
4/9/15 1:00,0,103,14,10,127
4/9/15 2:00,0,92,10,4,106
4/9/15 3:00,0,60,9,8,77
4/9/15 4:00,0,52,8,3,63
4/9/15 5:00,0,89,14,10,113
4/9/15 6:00,0,140,14,19,173
4/9/15 7:00,0,262,21,20,303
4/9/15 8:00,4,331,17,14,366
4/9/15 9:00,5,506,19,12,542
4/9/15 10:00,0,621,22,24,667
4/9/15 11:00,6,612,28,21,667
4/9/15 12:00,11,602,18,27,658
4/9/15 13:00,6,649,32,39,726
4/9/15 14:00,8,678,31,27,744
4/9/15 15:00,4,640,23,15,682
4/9/15 16:00,0,677,25,27,729
4/9/15 17:00,6,660,21,22,709
4/9/15 18:00,5,561,22,14,602
4/9/15 19:00,5,650,15,13,683
4/9/15 20:00,4,463,17,14,498
4/9/15 21:00,2,347,12,7,368
4/9/15 22:00,3,254,13,9,279
4/9/15 23:00,1,173,10,5,189
5/9/15 0:00,2,117,10,4,133
5/9/15 1:00,0,109,11,3,123
5/9/15 2:00,0,69,9,5,83
5/9/15 3:00,1,67,8,3,79
5/9/15 4:00,0,66,8,5,79
5/9/15 5:00,0,101,11,8,120
5/9/15 6:00,0,134,15,7,156
5/9/15 7:00,0,256,22,5,283
5/9/15 8:00,2,352,14,8,376
5/9/15 9:00,4,521,17,9,551
5/9/15 10:00,4,677,23,14,718
5/9/15 11:00,10,748,13,17,788
5/9/15 12:00,7,805,22,14,848
5/9/15 13:00,10,661,13,15,699
5/9/15 14:00,17,616,13,16,662
5/9/15 15:00,10,607,21,10,648
5/9/15 16:00,10,652,14,14,690
5/9/15 17:00,5,588,16,6,615
5/9/15 18:00,3,488,16,12,519
5/9/15 19:00,5,370,12,8,395
5/9/15 20:00,1,341,6,3,351
5/9/15 21:00,2,248,9,2,261
5/9/15 22:00,2,201,8,10,221
5/9/15 23:00,1,157,9,4,171
6/9/15 0:00,2,125,8,6,141
6/9/15 1:00,0,122,4,3,129
6/9/15 2:00,0,92,8,2,102
6/9/15 3:00,0,67,8,4,79
6/9/15 4:00,0,64,3,3,70
6/9/15 5:00,0,77,5,3,85
6/9/15 6:00,0,118,6,1,125
6/9/15 7:00,3,195,5,3,206
6/9/15 8:00,2,337,14,7,360
6/9/15 9:00,7,614,33,9,663
6/9/15 10:00,5,626,21,9,661
6/9/15 11:00,7,680,20,12,719
6/9/15 12:00,6,717,21,11,755
6/9/15 13:00,5,697,16,13,731
6/9/15 14:00,11,633,13,18,675
6/9/15 15:00,10,626,16,30,682
6/9/15 16:00,3,659,15,17,694
6/9/15 17:00,10,734,14,13,771
6/9/15 18:00,7,760,24,11,802
6/9/15 19:00,8,694,17,13,732
6/9/15 20:00,15,601,17,8,641
6/9/15 21:00,4,410,15,4,433
6/9/15 22:00,4,262,13,9,288
6/9/15 23:00,2,206,22,8,238
7/9/15 0:00,0,147,8,8,163
7/9/15 1:00,1,89,17,5,112
7/9/15 2:00,0,56,10,4,70
7/9/15 3:00,0,40,15,9,64
7/9/15 4:00,1,61,7,4,73
7/9/15 5:00,0,99,6,6,111
7/9/15 6:00,2,230,16,10,258
7/9/15 7:00,0,324,16,10,350
7/9/15 8:00,4,377,16,8,405
7/9/15 9:00,2,464,21,21,508
7/9/15 10:00,3,495,22,27,547
7/9/15 11:00,3,497,19,20,539
7/9/15 12:00,7,527,22,21,577
7/9/15 13:00,6,525,18,25,574
7/9/15 14:00,6,473,13,21,513
7/9/15 15:00,3,470,13,19,505
7/9/15 16:00,8,467,18,24,517
7/9/15 17:00,4,397,15,16,432
7/9/15 18:00,3,398,13,14,428
7/9/15 19:00,3,316,17,16,352
7/9/15 20:00,1,299,11,20,331
7/9/15 21:00,1,228,17,10,256
7/9/15 22:00,0,165,12,13,190
7/9/15 23:00,0,119,10,12,141
8/9/15 0:00,1,93,11,18,123
8/9/15 1:00,0,53,10,3,66
8/9/15 2:00,0,42,9,3,54
8/9/15 3:00,0,32,6,3,41
8/9/15 4:00,0,42,9,5,56
8/9/15 5:00,0,62,11,9,82
8/9/15 6:00,1,100,13,14,128
8/9/15 7:00,0,213,23,18,254
8/9/15 8:00,0,362,16,8,386
8/9/15 9:00,2,452,13,15,482
8/9/15 10:00,2,420,23,15,460
8/9/15 11:00,2,451,25,20,498
8/9/15 12:00,2,442,10,35,489
8/9/15 13:00,5,427,21,28,481
8/9/15 14:00,6,411,15,25,457
8/9/15 15:00,4,402,14,18,438
8/9/15 16:00,1,405,23,13,442
8/9/15 17:00,1,415,20,12,448
8/9/15 18:00,4,358,20,13,395
8/9/15 19:00,2,295,14,13,324
8/9/15 20:00,1,216,10,23,250
8/9/15 21:00,1,187,17,16,221
8/9/15 22:00,0,168,13,10,191
8/9/15 23:00,0,124,13,14,151
9/9/15 0:00,0,100,12,6,118
9/9/15 1:00,0,43,13,8,64
9/9/15 2:00,0,31,10,5,46
9/9/15 3:00,0,49,8,7,64
9/9/15 4:00,0,35,7,6,48
9/9/15 5:00,0,47,12,9,68
9/9/15 6:00,2,126,14,10,152
9/9/15 7:00,0,185,15,13,213
9/9/15 8:00,0,316,15,12,343
9/9/15 9:00,2,353,16,15,386
9/9/15 10:00,7,535,27,26,595
9/9/15 11:00,9,463,30,25,527
9/9/15 12:00,1,460,25,27,513
9/9/15 13:00,9,446,18,41,514
9/9/15 14:00,5,504,22,27,558
9/9/15 15:00,3,490,17,19,529
9/9/15 16:00,7,441,26,13,487
9/9/15 17:00,4,364,18,23,409
9/9/15 18:00,2,341,15,19,377
9/9/15 19:00,3,301,22,19,345
9/9/15 20:00,1,278,7,22,308
9/9/15 21:00,1,189,18,13,221
9/9/15 22:00,2,239,18,14,273
9/9/15 23:00,1,155,26,12,194
10/9/15 0:00,0,93,23,13,129
10/9/15 1:00,0,64,9,7,80
10/9/15 2:00,0,54,7,9,70
10/9/15 3:00,0,58,12,4,74
10/9/15 4:00,0,43,9,2,54
10/9/15 5:00,0,70,10,6,86
10/9/15 6:00,0,137,12,13,162
10/9/15 7:00,0,205,18,13,236
10/9/15 8:00,0,315,22,6,343
10/9/15 9:00,2,359,22,12,395
10/9/15 10:00,4,417,28,14,463
10/9/15 11:00,4,505,21,28,558
10/9/15 12:00,5,483,23,24,535
10/9/15 13:00,4,510,30,34,578
10/9/15 14:00,4,425,11,33,473
10/9/15 15:00,6,468,22,32,528
10/9/15 16:00,3,467,26,10,506
10/9/15 17:00,5,433,19,12,469
10/9/15 18:00,0,373,21,14,408
10/9/15 19:00,0,355,13,13,381
10/9/15 20:00,0,271,17,25,313
10/9/15 21:00,0,208,20,14,242
10/9/15 22:00,0,211,12,8,231
10/9/15 23:00,0,106,10,8,124
11/9/15 0:00,0,73,8,12,93
11/9/15 1:00,0,78,13,4,95
11/9/15 2:00,0,47,9,3,59
11/9/15 3:00,0,45,11,10,66
11/9/15 4:00,0,37,7,7,51
11/9/15 5:00,0,63,16,4,83
11/9/15 6:00,0,127,17,15,159
11/9/15 7:00,0,203,16,20,239
11/9/15 8:00,1,279,11,15,306
11/9/15 9:00,2,328,13,11,354
11/9/15 10:00,6,427,11,17,461
11/9/15 11:00,4,454,13,18,489
11/9/15 12:00,3,490,15,42,550
11/9/15 13:00,5,489,26,30,550
11/9/15 14:00,6,545,21,30,602
11/9/15 15:00,11,517,14,30,572
11/9/15 16:00,2,531,22,24,579
11/9/15 17:00,3,502,19,16,540
11/9/15 18:00,2,457,18,8,485
11/9/15 19:00,5,427,21,13,466
11/9/15 20:00,3,343,15,16,377
11/9/15 21:00,1,252,17,8,278
11/9/15 22:00,1,190,11,3,205
11/9/15 23:00,0,133,14,6,153
12/9/15 0:00,0,93,13,2,108
12/9/15 1:00,3,58,8,11,80
12/9/15 2:00,0,72,12,2,86
12/9/15 3:00,0,50,8,4,62
12/9/15 4:00,0,51,5,1,57
12/9/15 5:00,0,57,4,0,61
12/9/15 6:00,0,110,8,4,122
12/9/15 7:00,0,195,23,6,224
12/9/15 8:00,5,289,13,13,320
12/9/15 9:00,0,388,15,7,410
12/9/15 10:00,3,461,18,5,487
12/9/15 11:00,4,535,17,7,563
12/9/15 12:00,1,507,13,16,537
12/9/15 13:00,8,488,13,11,520
12/9/15 14:00,4,460,10,14,488
12/9/15 15:00,4,454,15,17,490
12/9/15 16:00,4,452,14,13,483
12/9/15 17:00,7,449,18,3,477
12/9/15 18:00,7,411,13,13,444
12/9/15 19:00,7,333,8,8,356
12/9/15 20:00,3,265,6,3,277
12/9/15 21:00,2,197,10,2,211
12/9/15 22:00,2,161,11,3,177
12/9/15 23:00,1,284,26,8,319
13/9/15 0:00,0,115,14,5,134
13/9/15 1:00,1,117,10,1,129
13/9/15 2:00,0,71,8,1,80
13/9/15 3:00,0,88,5,1,94
13/9/15 4:00,0,53,6,5,64
13/9/15 5:00,0,53,5,5,63
13/9/15 6:00,1,90,5,5,101
13/9/15 7:00,2,159,8,5,174
13/9/15 8:00,3,241,10,6,260
13/9/15 9:00,7,291,12,6,316
13/9/15 10:00,21,392,16,10,439
13/9/15 11:00,39,466,15,18,538
13/9/15 12:00,23,552,14,20,609
13/9/15 13:00,12,520,11,13,556
13/9/15 14:00,7,464,16,17,504
13/9/15 15:00,2,522,8,6,538
13/9/15 16:00,3,587,12,7,609
13/9/15 17:00,9,656,18,15,698
13/9/15 18:00,8,576,17,18,619
13/9/15 19:00,7,498,13,10,528
13/9/15 20:00,7,475,22,11,515
13/9/15 21:00,1,305,13,13,332
13/9/15 22:00,3,197,10,10,220
13/9/15 23:00,1,135,14,6,156
14/9/15 0:00,1,87,16,6,110
14/9/15 1:00,2,69,14,9,94
14/9/15 2:00,0,38,8,4,50
14/9/15 3:00,0,36,6,8,50
14/9/15 4:00,1,39,5,4,49
14/9/15 5:00,1,83,10,6,100
14/9/15 6:00,1,168,12,8,189
14/9/15 7:00,1,277,16,11,305
14/9/15 8:00,0,309,13,10,332
14/9/15 9:00,3,314,21,6,344
14/9/15 10:00,5,339,16,18,378
14/9/15 11:00,9,357,16,21,403
14/9/15 12:00,4,362,25,24,415
14/9/15 13:00,4,327,13,28,372
14/9/15 14:00,3,350,19,22,394
14/9/15 15:00,4,383,17,17,421
14/9/15 16:00,7,302,17,21,347
14/9/15 17:00,6,314,23,24,367
14/9/15 18:00,2,270,26,17,315
14/9/15 19:00,8,261,12,19,300
14/9/15 20:00,1,214,9,24,248
14/9/15 21:00,1,171,9,15,196
14/9/15 22:00,3,108,13,17,141
14/9/15 23:00,0,89,8,17,114
15/9/15 0:00,0,74,10,7,91
15/9/15 1:00,0,62,9,6,77
15/9/15 2:00,1,40,11,2,54
15/9/15 3:00,0,41,5,6,52
15/9/15 4:00,0,33,13,6,52
15/9/15 5:00,0,54,17,11,82
15/9/15 6:00,0,99,18,13,130
15/9/15 7:00,0,196,15,11,222
15/9/15 8:00,1,297,16,10,324
15/9/15 9:00,1,358,27,14,400
15/9/15 10:00,7,330,24,25,386
15/9/15 11:00,9,347,15,25,396
15/9/15 12:00,8,317,16,35,376
15/9/15 13:00,2,314,18,16,350
15/9/15 14:00,2,286,22,25,335
15/9/15 15:00,3,366,21,17,407
15/9/15 16:00,2,309,25,23,359
15/9/15 17:00,2,281,14,25,322
15/9/15 18:00,4,258,15,17,294
15/9/15 19:00,3,228,13,17,261
15/9/15 20:00,1,145,11,19,176
15/9/15 21:00,2,159,15,14,190
15/9/15 22:00,0,118,11,13,142
15/9/15 23:00,0,71,13,14,98
16/9/15 0:00,1,50,6,10,67
16/9/15 1:00,0,34,11,8,53
16/9/15 2:00,0,35,7,12,54
16/9/15 3:00,0,35,6,6,47
16/9/15 4:00,1,34,8,11,54
16/9/15 5:00,1,45,13,10,69
16/9/15 6:00,0,99,19,7,125
16/9/15 7:00,1,167,20,17,205
16/9/15 8:00,2,248,12,14,276
16/9/15 9:00,0,347,15,23,385
16/9/15 10:00,3,327,26,22,378
16/9/15 11:00,1,302,18,14,335
16/9/15 12:00,2,315,20,33,370
16/9/15 13:00,2,305,17,30,354
16/9/15 14:00,2,374,18,15,409
16/9/15 15:00,3,362,15,20,400
16/9/15 16:00,4,380,19,14,417
16/9/15 17:00,2,326,16,20,364
16/9/15 18:00,7,255,18,9,289
16/9/15 19:00,5,258,19,14,296
16/9/15 20:00,3,218,12,9,242
16/9/15 21:00,3,161,14,16,194
16/9/15 22:00,1,136,10,12,159
16/9/15 23:00,1,113,39,19,172
17/9/15 0:00,1,55,20,7,83
17/9/15 1:00,0,48,11,13,72
17/9/15 2:00,0,38,11,8,57
17/9/15 3:00,0,43,7,7,57
17/9/15 4:00,1,32,9,5,47
17/9/15 5:00,0,58,18,10,86
17/9/15 6:00,0,122,29,20,171
17/9/15 7:00,2,240,30,11,283
17/9/15 8:00,1,271,25,15,312
17/9/15 9:00,2,298,18,15,333
17/9/15 10:00,2,362,19,16,399
17/9/15 11:00,0,389,22,42,453
17/9/15 12:00,3,377,22,30,432
17/9/15 13:00,1,366,23,36,426
17/9/15 14:00,7,366,22,27,422
17/9/15 15:00,2,418,18,20,458
17/9/15 16:00,7,444,29,24,504
17/9/15 17:00,3,435,20,28,486
17/9/15 18:00,2,425,21,19,467
17/9/15 19:00,0,313,19,12,344
17/9/15 20:00,5,271,17,17,310
17/9/15 21:00,1,199,10,15,225
17/9/15 22:00,1,155,12,20,188
17/9/15 23:00,0,93,23,16,132
18/9/15 0:00,0,61,8,19,88
18/9/15 1:00,1,55,8,10,74
18/9/15 2:00,1,43,10,8,62
18/9/15 3:00,0,37,10,5,52
18/9/15 4:00,0,31,7,7,45
18/9/15 5:00,0,63,15,7,85
18/9/15 6:00,0,94,17,13,124
18/9/15 7:00,1,195,17,15,228
18/9/15 8:00,0,281,14,13,308
18/9/15 9:00,2,359,20,13,394
18/9/15 10:00,1,452,24,23,500
18/9/15 11:00,0,462,18,27,507
18/9/15 12:00,3,437,20,38,498
18/9/15 13:00,2,534,20,32,588
18/9/15 14:00,3,495,27,37,562
18/9/15 15:00,8,503,20,26,557
18/9/15 16:00,7,577,20,15,619
18/9/15 17:00,3,570,20,18,611
18/9/15 18:00,4,507,16,21,548
18/9/15 19:00,3,486,24,15,528
18/9/15 20:00,5,400,15,12,432
18/9/15 21:00,1,247,20,16,284
18/9/15 22:00,0,218,8,4,230
18/9/15 23:00,2,142,14,5,163
19/9/15 0:00,0,81,12,9,102
19/9/15 1:00,0,64,15,11,90
19/9/15 2:00,0,65,10,3,78
19/9/15 3:00,0,43,12,3,58
19/9/15 4:00,1,42,6,0,49
19/9/15 5:00,0,65,7,6,78
19/9/15 6:00,0,90,11,5,106
19/9/15 7:00,1,188,16,8,213
19/9/15 8:00,3,265,12,13,293
19/9/15 9:00,3,356,18,11,388
19/9/15 10:00,4,452,10,19,485
19/9/15 11:00,6,518,14,10,548
19/9/15 12:00,1,504,15,17,537
19/9/15 13:00,9,472,10,17,508
19/9/15 14:00,6,421,16,17,460
19/9/15 15:00,2,443,14,14,473
19/9/15 16:00,5,440,16,13,474
19/9/15 17:00,10,432,20,10,472
19/9/15 18:00,6,391,16,13,426
19/9/15 19:00,0,296,12,11,319
19/9/15 20:00,3,274,11,8,296
19/9/15 21:00,4,204,6,6,220
19/9/15 22:00,2,142,9,3,156
19/9/15 23:00,2,199,18,1,220
20/9/15 0:00,1,127,24,2,154
20/9/15 1:00,1,91,8,2,102
20/9/15 2:00,0,52,11,3,66
20/9/15 3:00,0,71,11,2,84
20/9/15 4:00,0,46,10,4,60
20/9/15 5:00,0,35,7,3,45
20/9/15 6:00,0,66,10,2,78
20/9/15 7:00,1,148,4,2,155
20/9/15 8:00,5,230,11,7,253
20/9/15 9:00,2,355,8,8,373
20/9/15 10:00,11,522,7,18,558
20/9/15 11:00,8,590,10,15,623
20/9/15 12:00,10,604,15,15,644
20/9/15 13:00,8,586,18,12,624
20/9/15 14:00,8,548,15,16,587
20/9/15 15:00,12,550,10,14,586
20/9/15 16:00,7,656,19,21,703
20/9/15 17:00,10,585,8,15,618
20/9/15 18:00,4,497,15,18,534
20/9/15 19:00,7,440,12,15,474
20/9/15 20:00,4,364,16,18,402
20/9/15 21:00,1,287,14,7,309
20/9/15 22:00,3,184,6,7,200
20/9/15 23:00,0,125,11,12,148
21/9/15 0:00,2,99,10,3,114
21/9/15 1:00,0,56,9,7,72
21/9/15 2:00,0,52,8,7,67
21/9/15 3:00,0,25,14,4,43
21/9/15 4:00,0,46,7,7,60
21/9/15 5:00,0,63,7,6,76
21/9/15 6:00,0,132,18,11,161
21/9/15 7:00,0,227,19,13,259
21/9/15 8:00,1,336,12,13,362
21/9/15 9:00,5,372,20,14,411
21/9/15 10:00,7,384,22,20,433
21/9/15 11:00,6,423,17,22,468
21/9/15 12:00,9,454,22,23,508
21/9/15 13:00,6,473,26,21,526
21/9/15 14:00,8,458,25,19,510
21/9/15 15:00,6,460,16,25,507
21/9/15 16:00,3,529,18,15,565
21/9/15 17:00,1,474,26,22,523
21/9/15 18:00,2,450,17,17,486
21/9/15 19:00,3,380,16,17,416
21/9/15 20:00,1,261,11,20,293
21/9/15 21:00,0,205,12,16,233
21/9/15 22:00,0,132,12,11,155
21/9/15 23:00,1,98,8,6,113
22/9/15 0:00,1,58,12,7,78
22/9/15 1:00,1,48,8,3,60
22/9/15 2:00,1,30,8,4,43
22/9/15 3:00,0,36,7,5,48
22/9/15 4:00,0,26,10,6,42
22/9/15 5:00,0,47,7,12,66
22/9/15 6:00,0,106,17,10,133
22/9/15 7:00,0,183,20,18,221
22/9/15 8:00,1,315,18,15,349
22/9/15 9:00,3,334,13,23,373
22/9/15 10:00,5,416,27,27,475
22/9/15 11:00,2,413,24,29,468
22/9/15 12:00,5,452,16,35,508
22/9/15 13:00,5,398,13,27,443
22/9/15 14:00,5,406,20,23,454
22/9/15 15:00,1,339,24,19,383
22/9/15 16:00,2,400,12,17,431
22/9/15 17:00,2,386,23,21,432
22/9/15 18:00,1,335,21,24,381
22/9/15 19:00,2,232,15,22,271
22/9/15 20:00,0,195,8,12,215
22/9/15 21:00,0,160,18,17,195
22/9/15 22:00,0,112,9,8,129
22/9/15 23:00,2,117,14,10,143
23/9/15 0:00,0,75,9,6,90
23/9/15 1:00,0,35,8,9,52
23/9/15 2:00,0,30,11,0,41
23/9/15 3:00,0,22,8,7,37
23/9/15 4:00,0,26,9,7,42
23/9/15 5:00,0,47,10,9,66
23/9/15 6:00,0,92,10,11,113
23/9/15 7:00,1,162,15,5,183
23/9/15 8:00,0,253,12,16,281
23/9/15 9:00,2,290,17,21,330
23/9/15 10:00,1,334,27,25,387
23/9/15 11:00,2,329,14,27,372
23/9/15 12:00,5,334,24,37,400
23/9/15 13:00,5,342,16,21,384
23/9/15 14:00,7,393,16,29,445
23/9/15 15:00,0,363,25,16,404
23/9/15 16:00,2,398,23,20,443
23/9/15 17:00,3,357,17,16,393
23/9/15 18:00,2,289,12,20,323
23/9/15 19:00,0,274,14,13,301
23/9/15 20:00,1,177,11,10,199
23/9/15 21:00,0,134,14,13,161
23/9/15 22:00,0,129,14,11,154
23/9/15 23:00,1,115,34,14,164
24/9/15 0:00,2,127,15,13,157
24/9/15 1:00,0,50,16,4,70
24/9/15 2:00,0,30,11,3,44
24/9/15 3:00,0,34,7,5,46
24/9/15 4:00,0,32,7,2,41
24/9/15 5:00,0,36,7,5,48
24/9/15 6:00,0,106,18,16,140
24/9/15 7:00,3,182,30,9,224
24/9/15 8:00,2,228,23,11,264
24/9/15 9:00,1,354,23,13,391
24/9/15 10:00,2,331,24,24,381
24/9/15 11:00,1,336,19,40,396
24/9/15 12:00,1,325,20,35,381
24/9/15 13:00,3,365,20,21,409
24/9/15 14:00,3,320,20,20,363
24/9/15 15:00,2,355,22,18,397
24/9/15 16:00,1,342,19,15,377
24/9/15 17:00,2,330,18,15,365
24/9/15 18:00,2,290,18,14,324
24/9/15 19:00,2,231,18,11,262
24/9/15 20:00,0,187,12,17,216
24/9/15 21:00,0,166,16,20,202
24/9/15 22:00,0,85,21,16,122
24/9/15 23:00,0,80,17,11,108
25/9/15 0:00,0,48,10,4,62
25/9/15 1:00,0,40,8,5,53
25/9/15 2:00,0,24,5,2,31
25/9/15 3:00,0,22,6,0,28
25/9/15 4:00,0,30,11,5,46
25/9/15 5:00,0,45,9,3,57
25/9/15 6:00,0,95,22,21,138
25/9/15 7:00,0,174,21,17,212
25/9/15 8:00,2,252,13,13,280
25/9/15 9:00,5,319,18,9,351
25/9/15 10:00,7,345,16,34,402
25/9/15 11:00,4,393,29,22,448
25/9/15 12:00,7,420,22,25,474
25/9/15 13:00,8,395,20,27,450
25/9/15 14:00,5,468,20,28,521
25/9/15 15:00,3,444,25,18,490
25/9/15 16:00,6,530,19,16,571
25/9/15 17:00,1,486,20,16,523
25/9/15 18:00,4,526,20,16,566
25/9/15 19:00,1,383,19,11,414
25/9/15 20:00,1,293,12,8,314
25/9/15 21:00,1,217,11,3,232
25/9/15 22:00,1,142,8,6,157
25/9/15 23:00,0,76,11,8,95
26/9/15 0:00,0,55,8,1,64
26/9/15 1:00,0,43,10,1,54
26/9/15 2:00,0,37,5,3,45
26/9/15 3:00,0,31,5,3,39
26/9/15 4:00,0,36,4,1,41
26/9/15 5:00,0,47,6,3,56
26/9/15 6:00,0,78,7,1,86
26/9/15 7:00,0,135,8,3,146
26/9/15 8:00,2,263,15,8,288
26/9/15 9:00,15,325,16,5,361
26/9/15 10:00,1,460,19,13,493
26/9/15 11:00,1,504,12,9,526
26/9/15 12:00,2,495,11,18,526
26/9/15 13:00,17,484,14,11,526
26/9/15 14:00,3,427,8,12,450
26/9/15 15:00,2,389,15,12,418
26/9/15 16:00,3,442,15,9,469
26/9/15 17:00,0,440,11,10,461
26/9/15 18:00,4,355,14,5,378
26/9/15 19:00,2,261,13,9,285
26/9/15 20:00,0,214,10,6,230
26/9/15 21:00,1,163,16,3,183
26/9/15 22:00,1,127,10,4,142
26/9/15 23:00,1,179,14,6,200
27/9/15 0:00,0,95,27,3,125
27/9/15 1:00,0,82,10,2,94
27/9/15 2:00,0,37,5,2,44
27/9/15 3:00,0,53,7,0,60
27/9/15 4:00,0,41,6,6,53
27/9/15 5:00,0,51,6,1,58
27/9/15 6:00,0,97,5,6,108
27/9/15 7:00,2,197,8,4,211
27/9/15 8:00,0,211,9,4,224
27/9/15 9:00,1,295,14,12,322
27/9/15 10:00,4,325,21,2,352
27/9/15 11:00,3,478,21,4,506
27/9/15 12:00,11,493,10,16,530
27/9/15 13:00,9,421,21,10,461
27/9/15 14:00,4,465,19,13,501
27/9/15 15:00,5,523,17,8,553
27/9/15 16:00,2,544,19,6,571
27/9/15 17:00,5,547,19,21,592
27/9/15 18:00,5,603,21,14,643
27/9/15 19:00,2,482,12,12,508
27/9/15 20:00,3,460,14,18,495
27/9/15 21:00,16,258,24,9,307
27/9/15 22:00,2,157,13,11,183
27/9/15 23:00,0,110,17,5,132
28/9/15 0:00,0,87,12,10,109
28/9/15 1:00,0,49,11,1,61
28/9/15 2:00,0,30,10,6,46
28/9/15 3:00,0,40,5,7,52
28/9/15 4:00,0,33,9,3,45
28/9/15 5:00,0,60,9,6,75
28/9/15 6:00,0,148,11,12,171
28/9/15 7:00,0,230,14,13,257
28/9/15 8:00,1,254,8,10,273
28/9/15 9:00,1,359,18,13,391
28/9/15 10:00,15,341,27,15,398
28/9/15 11:00,1,312,19,18,350
28/9/15 12:00,3,325,22,21,371
28/9/15 13:00,2,317,22,25,366
28/9/15 14:00,4,302,18,22,346
28/9/15 15:00,2,347,22,17,388
28/9/15 16:00,6,341,26,14,387
28/9/15 17:00,2,345,16,25,388
28/9/15 18:00,1,279,18,27,325
28/9/15 19:00,2,204,15,17,238
28/9/15 20:00,1,183,11,16,211
28/9/15 21:00,0,123,10,7,140
28/9/15 22:00,0,107,12,10,129
28/9/15 23:00,1,67,9,3,80
29/9/15 0:00,0,59,8,6,73
29/9/15 1:00,0,35,8,5,48
29/9/15 2:00,0,36,7,3,46
29/9/15 3:00,0,24,8,5,37
29/9/15 4:00,0,14,9,6,29
29/9/15 5:00,0,33,11,4,48
29/9/15 6:00,1,73,8,13,95
29/9/15 7:00,0,183,8,10,201
29/9/15 8:00,0,221,16,11,248
29/9/15 9:00,1,305,17,16,339
29/9/15 10:00,1,327,16,15,359
29/9/15 11:00,0,278,14,19,311
29/9/15 12:00,3,281,16,24,324
29/9/15 13:00,1,286,18,34,339
29/9/15 14:00,0,262,11,22,295
29/9/15 15:00,2,308,23,18,351
29/9/15 16:00,2,304,16,12,334
29/9/15 17:00,1,244,11,28,284
29/9/15 18:00,0,257,23,26,306
29/9/15 19:00,1,183,19,18,221
29/9/15 20:00,0,190,16,17,223
29/9/15 21:00,2,145,12,11,170
29/9/15 22:00,0,90,11,16,117
29/9/15 23:00,0,58,9,10,77
30/9/15 0:00,0,38,6,4,48
30/9/15 1:00,0,40,4,8,52
30/9/15 2:00,0,22,7,3,32
30/9/15 3:00,0,24,7,3,34
30/9/15 4:00,0,19,4,7,30
30/9/15 5:00,0,29,14,12,55
30/9/15 6:00,1,93,12,10,116
30/9/15 7:00,0,164,16,12,192
30/9/15 8:00,0,221,11,15,247
30/9/15 9:00,0,296,16,16,328
30/9/15 10:00,0,293,21,26,340
30/9/15 11:00,1,308,18,23,350
30/9/15 12:00,1,301,22,30,354
30/9/15 13:00,1,308,24,40,373
30/9/15 14:00,8,383,14,38,443
30/9/15 15:00,1,341,13,12,367
30/9/15 16:00,1,311,22,14,348
30/9/15 17:00,2,305,25,29,361
30/9/15 18:00,1,280,18,13,312
30/9/15 19:00,0,216,19,19,254
30/9/15 20:00,0,206,9,17,232
30/9/15 21:00,0,166,11,12,189
30/9/15 22:00,0,140,17,12,169
30/9/15 23:00,0,102,31,14,147
1/10/15 0:00,0,52,11,13,76
1/10/15 1:00,0,42,3,6,51
1/10/15 2:00,0,22,11,9,42
1/10/15 3:00,0,28,6,7,41
1/10/15 4:00,0,37,12,10,59
1/10/15 5:00,0,44,12,10,66
1/10/15 6:00,1,122,12,15,150
1/10/15 7:00,1,202,20,7,230
1/10/15 8:00,2,258,18,19,297
1/10/15 9:00,3,330,18,13,364
1/10/15 10:00,2,305,17,21,345
1/10/15 11:00,0,313,16,29,358
1/10/15 12:00,2,323,18,34,377
1/10/15 13:00,3,299,19,28,349
1/10/15 14:00,1,351,18,39,409
1/10/15 15:00,3,337,21,31,392
1/10/15 16:00,7,394,23,29,453
1/10/15 17:00,1,387,19,15,422
1/10/15 18:00,1,368,18,17,404
1/10/15 19:00,0,255,12,21,288
1/10/15 20:00,0,193,6,11,210
1/10/15 21:00,0,163,17,14,194
1/10/15 22:00,0,131,12,12,155
1/10/15 23:00,0,74,10,15,99
2/10/15 0:00,0,45,14,7,66
2/10/15 1:00,0,129,9,9,147
2/10/15 2:00,0,134,13,3,150
2/10/15 3:00,0,31,7,1,39
2/10/15 4:00,0,32,12,6,50
2/10/15 5:00,0,53,8,5,66
2/10/15 6:00,0,83,9,13,105
2/10/15 7:00,0,155,15,14,184
2/10/15 8:00,0,220,5,17,242
2/10/15 9:00,0,291,21,23,335
2/10/15 10:00,7,340,23,24,394
2/10/15 11:00,0,334,19,29,382
2/10/15 12:00,4,351,20,43,418
2/10/15 13:00,1,362,20,35,418
2/10/15 14:00,10,444,17,32,503
2/10/15 15:00,2,488,14,20,524
2/10/15 16:00,3,542,29,26,600
2/10/15 17:00,1,520,17,30,568
2/10/15 18:00,1,460,13,16,490
2/10/15 19:00,1,396,19,17,433
2/10/15 20:00,4,310,12,13,339
2/10/15 21:00,0,260,15,22,297
2/10/15 22:00,0,150,14,6,170
2/10/15 23:00,1,96,12,11,120
3/10/15 0:00,0,87,22,6,115
3/10/15 1:00,0,56,11,4,71
3/10/15 2:00,0,42,8,6,56
3/10/15 3:00,0,35,5,1,41
3/10/15 4:00,0,35,8,3,46
3/10/15 5:00,1,54,7,4,66
3/10/15 6:00,1,111,7,3,122
3/10/15 7:00,1,158,12,5,176
3/10/15 8:00,0,258,10,6,274
3/10/15 9:00,0,365,21,15,401
3/10/15 10:00,7,390,18,12,427
3/10/15 11:00,3,460,14,8,485
3/10/15 12:00,2,344,13,20,379
3/10/15 13:00,2,385,12,24,423
3/10/15 14:00,2,346,17,9,374
3/10/15 15:00,0,356,10,17,383
3/10/15 16:00,2,468,23,5,498
3/10/15 17:00,5,413,16,19,453
3/10/15 18:00,0,331,21,8,360
3/10/15 19:00,3,287,16,4,310
3/10/15 20:00,1,247,8,5,261
3/10/15 21:00,0,181,10,6,197
3/10/15 22:00,0,121,14,4,139
3/10/15 23:00,2,226,14,7,249
4/10/15 0:00,0,113,17,2,132
4/10/15 1:00,0,61,9,0,70
4/10/15 2:00,0,41,8,1,50
4/10/15 3:00,0,33,4,1,38
4/10/15 4:00,0,29,4,2,35
4/10/15 5:00,0,48,7,1,56
4/10/15 6:00,1,87,7,1,96
4/10/15 7:00,2,155,7,2,166
4/10/15 8:00,0,209,19,7,235
4/10/15 9:00,4,255,11,5,275
4/10/15 10:00,2,352,11,10,375
4/10/15 11:00,2,414,10,10,436
4/10/15 12:00,32,458,15,25,530
4/10/15 13:00,1,446,18,9,474
4/10/15 14:00,3,472,15,17,507
4/10/15 15:00,5,478,12,27,522
4/10/15 16:00,2,582,15,17,616
4/10/15 17:00,3,643,17,20,683
4/10/15 18:00,16,639,27,21,703
4/10/15 19:00,1,510,18,9,538
4/10/15 20:00,5,372,21,8,406
4/10/15 21:00,0,245,21,9,275
4/10/15 22:00,0,137,18,12,167
4/10/15 23:00,1,154,9,17,181
5/10/15 0:00,1,199,15,6,221
5/10/15 1:00,0,76,9,8,93
5/10/15 2:00,0,28,4,2,34
5/10/15 3:00,0,33,6,5,44
5/10/15 4:00,0,33,8,8,49
5/10/15 5:00,0,71,6,8,85
5/10/15 6:00,1,151,11,17,180
5/10/15 7:00,1,258,17,21,297
5/10/15 8:00,0,294,6,13,313
5/10/15 9:00,2,340,20,13,375
5/10/15 10:00,0,301,18,28,347
5/10/15 11:00,1,287,21,37,346
5/10/15 12:00,1,304,13,25,343
5/10/15 13:00,3,274,20,25,322
5/10/15 14:00,0,292,12,24,328
5/10/15 15:00,3,308,17,25,353
5/10/15 16:00,3,324,18,17,362
5/10/15 17:00,3,353,22,16,394
5/10/15 18:00,0,290,12,19,321
5/10/15 19:00,4,222,21,16,263
5/10/15 20:00,0,219,4,10,233
5/10/15 21:00,2,152,15,10,179
5/10/15 22:00,0,115,13,13,141
5/10/15 23:00,0,82,9,10,101
6/10/15 0:00,0,60,8,12,80
6/10/15 1:00,0,29,6,4,39
6/10/15 2:00,0,34,11,2,47
6/10/15 3:00,0,19,7,5,31
6/10/15 4:00,0,24,8,5,37
6/10/15 5:00,0,51,8,8,67
6/10/15 6:00,0,90,20,10,120
6/10/15 7:00,0,176,14,13,203
6/10/15 8:00,0,264,25,21,310
6/10/15 9:00,1,321,15,13,350
6/10/15 10:00,4,313,19,30,366
6/10/15 11:00,2,277,12,21,312
6/10/15 12:00,1,230,22,34,287
6/10/15 13:00,1,252,17,35,305
6/10/15 14:00,5,230,16,23,274
6/10/15 15:00,2,248,13,23,286
6/10/15 16:00,0,287,18,21,326
6/10/15 17:00,2,262,16,24,304
6/10/15 18:00,0,204,24,16,244
6/10/15 19:00,0,222,16,9,247
6/10/15 20:00,2,144,5,20,171
6/10/15 21:00,0,132,19,9,160
6/10/15 22:00,0,123,12,13,148
6/10/15 23:00,1,64,9,9,83
7/10/15 0:00,1,47,5,10,63
7/10/15 1:00,0,38,3,6,47
7/10/15 2:00,0,21,9,5,35
7/10/15 3:00,0,21,7,11,39
7/10/15 4:00,0,32,7,11,50
7/10/15 5:00,0,29,11,10,50
7/10/15 6:00,0,89,8,16,113
7/10/15 7:00,0,162,12,13,187
7/10/15 8:00,1,207,13,16,237
7/10/15 9:00,2,287,12,19,320
7/10/15 10:00,3,282,26,32,343
7/10/15 11:00,0,240,15,19,274
7/10/15 12:00,2,243,17,45,307
7/10/15 13:00,0,254,17,37,308
7/10/15 14:00,0,331,19,30,380
7/10/15 15:00,0,288,15,21,324
7/10/15 16:00,1,296,24,21,342
7/10/15 17:00,1,272,16,17,306
7/10/15 18:00,1,219,13,13,246
7/10/15 19:00,0,206,13,12,231
7/10/15 20:00,0,177,10,14,201
7/10/15 21:00,1,161,12,21,195
7/10/15 22:00,0,105,10,24,139
7/10/15 23:00,0,119,27,14,160
8/10/15 0:00,0,58,22,6,86
8/10/15 1:00,0,50,13,1,64
8/10/15 2:00,0,23,8,3,34
8/10/15 3:00,0,26,8,5,39
8/10/15 4:00,0,32,12,3,47
8/10/15 5:00,0,39,10,10,59
8/10/15 6:00,0,71,11,14,96
8/10/15 7:00,0,186,20,16,222
8/10/15 8:00,0,252,13,10,275
8/10/15 9:00,1,300,20,16,337
8/10/15 10:00,2,308,23,29,362
8/10/15 11:00,1,293,18,23,335
8/10/15 12:00,1,298,16,23,338
8/10/15 13:00,1,277,24,25,327
8/10/15 14:00,0,297,15,25,337
8/10/15 15:00,0,321,18,37,376
8/10/15 16:00,0,300,17,28,345
8/10/15 17:00,0,290,19,23,332
8/10/15 18:00,0,263,13,11,287
8/10/15 19:00,0,199,17,16,232
8/10/15 20:00,0,202,7,17,226
8/10/15 21:00,0,143,13,16,172
8/10/15 22:00,0,113,15,6,134
8/10/15 23:00,0,66,14,17,97
9/10/15 0:00,0,39,9,8,56
9/10/15 1:00,0,36,9,9,54
9/10/15 2:00,0,34,6,4,44
9/10/15 3:00,0,23,6,12,41
9/10/15 4:00,0,27,4,3,34
9/10/15 5:00,0,33,9,19,61
9/10/15 6:00,0,80,14,14,108
9/10/15 7:00,0,158,18,13,189
9/10/15 8:00,0,245,13,16,274
9/10/15 9:00,2,303,11,13,329
9/10/15 10:00,1,319,28,25,373
9/10/15 11:00,0,324,23,30,377
9/10/15 12:00,1,313,15,24,353
9/10/15 13:00,1,389,18,30,438
9/10/15 14:00,2,418,14,30,464
9/10/15 15:00,0,475,16,23,514
9/10/15 16:00,1,484,26,26,537
9/10/15 17:00,3,464,24,21,512
9/10/15 18:00,1,398,19,17,435
9/10/15 19:00,0,342,18,20,380
9/10/15 20:00,0,308,9,17,334
9/10/15 21:00,0,180,17,9,206
9/10/15 22:00,0,128,18,12,158
9/10/15 23:00,0,137,5,8,150
10/10/15 0:00,0,64,22,6,92
10/10/15 1:00,0,38,7,4,49
10/10/15 2:00,0,51,5,8,64
10/10/15 3:00,0,33,5,4,42
10/10/15 4:00,0,35,9,6,50
10/10/15 5:00,0,61,5,6,72
10/10/15 6:00,0,84,11,4,99
10/10/15 7:00,0,138,18,6,162
10/10/15 8:00,2,186,15,9,212
10/10/15 9:00,2,282,14,13,311
10/10/15 10:00,0,369,21,12,402
10/10/15 11:00,1,387,12,19,419
10/10/15 12:00,3,358,15,19,395
10/10/15 13:00,1,352,18,13,384
10/10/15 14:00,3,319,11,20,353
10/10/15 15:00,0,358,10,14,382
10/10/15 16:00,1,372,14,16,403
10/10/15 17:00,0,370,18,13,401
10/10/15 18:00,0,278,16,6,300
10/10/15 19:00,0,242,13,9,264
10/10/15 20:00,0,224,11,7,242
10/10/15 21:00,0,186,10,3,199
10/10/15 22:00,0,141,12,3,156
10/10/15 23:00,0,149,16,7,172
11/10/15 0:00,2,100,34,8,144
11/10/15 1:00,0,54,12,2,68
11/10/15 2:00,0,32,5,4,41
11/10/15 3:00,0,26,7,2,35
11/10/15 4:00,0,36,4,2,42
11/10/15 5:00,0,28,7,2,37
11/10/15 6:00,0,76,5,4,85
11/10/15 7:00,2,123,7,1,133
11/10/15 8:00,1,141,8,3,153
11/10/15 9:00,0,207,13,7,227
11/10/15 10:00,0,276,17,15,308
11/10/15 11:00,2,355,11,13,381
11/10/15 12:00,0,372,13,12,397
11/10/15 13:00,2,386,13,15,416
11/10/15 14:00,1,396,16,18,431
11/10/15 15:00,0,447,11,17,475
11/10/15 16:00,0,515,18,20,553
11/10/15 17:00,1,469,11,13,494
11/10/15 18:00,0,533,22,26,581
11/10/15 19:00,0,400,18,7,425
11/10/15 20:00,2,324,19,10,355
11/10/15 21:00,0,252,17,9,278
11/10/15 22:00,0,128,14,8,150
11/10/15 23:00,0,88,13,6,107
12/10/15 0:00,0,70,9,8,87
12/10/15 1:00,0,42,8,5,55
12/10/15 2:00,0,26,6,4,36
12/10/15 3:00,0,22,4,5,31
12/10/15 4:00,0,37,4,7,48
12/10/15 5:00,0,53,5,5,63
12/10/15 6:00,1,126,12,11,150
12/10/15 7:00,0,230,14,9,253
12/10/15 8:00,0,289,10,10,309
12/10/15 9:00,0,310,18,22,350
12/10/15 10:00,0,295,21,15,331
12/10/15 11:00,1,264,17,36,318
12/10/15 12:00,3,253,15,21,292
12/10/15 13:00,2,229,20,24,275
12/10/15 14:00,3,276,18,38,335
12/10/15 15:00,1,285,14,16,316
12/10/15 16:00,2,274,22,27,325
12/10/15 17:00,1,273,21,26,321
12/10/15 18:00,4,209,17,22,252
12/10/15 19:00,0,242,13,24,279
12/10/15 20:00,0,163,4,23,190
12/10/15 21:00,0,122,22,11,155
12/10/15 22:00,0,110,17,10,137
12/10/15 23:00,0,69,8,9,86
13/10/15 0:00,0,67,5,8,80
13/10/15 1:00,0,37,11,9,57
13/10/15 2:00,0,23,7,3,33
13/10/15 3:00,0,24,9,2,35
13/10/15 4:00,0,35,9,5,49
13/10/15 5:00,0,42,10,8,60
13/10/15 6:00,0,97,17,8,122
13/10/15 7:00,0,172,11,8,191
13/10/15 8:00,0,249,16,8,273
13/10/15 9:00,1,289,9,11,310
13/10/15 10:00,1,316,22,21,360
13/10/15 11:00,2,230,19,23,274
13/10/15 12:00,1,245,21,28,295
13/10/15 13:00,3,271,17,23,314
13/10/15 14:00,2,269,16,28,315
13/10/15 15:00,2,281,12,38,333
13/10/15 16:00,5,286,24,13,328
13/10/15 17:00,3,261,19,21,304
13/10/15 18:00,1,234,15,18,268
13/10/15 19:00,0,204,17,23,244
13/10/15 20:00,0,181,10,24,215
13/10/15 21:00,1,149,15,15,180
13/10/15 22:00,0,123,18,7,148
13/10/15 23:00,0,79,16,15,110
14/10/15 0:00,0,49,12,11,72
14/10/15 1:00,0,21,7,8,36
14/10/15 2:00,0,15,9,5,29
14/10/15 3:00,0,23,5,6,34
14/10/15 4:00,0,25,8,12,45
14/10/15 5:00,0,35,10,11,56
14/10/15 6:00,0,83,19,8,110
14/10/15 7:00,0,148,16,10,174
14/10/15 8:00,0,237,18,14,269
14/10/15 9:00,0,310,17,17,344
14/10/15 10:00,0,291,22,22,335
14/10/15 11:00,1,230,20,18,269
14/10/15 12:00,2,247,20,25,294
14/10/15 13:00,1,234,14,39,288
14/10/15 14:00,0,274,18,31,323
14/10/15 15:00,1,314,14,25,354
14/10/15 16:00,1,313,19,21,354
14/10/15 17:00,0,302,17,18,337
14/10/15 18:00,3,287,21,13,324
14/10/15 19:00,0,246,16,23,285
14/10/15 20:00,1,196,23,27,247
14/10/15 21:00,0,144,26,21,191
14/10/15 22:00,0,95,11,19,125
14/10/15 23:00,0,74,12,17,103
15/10/15 0:00,0,58,11,6,75
15/10/15 1:00,0,37,13,7,57
15/10/15 2:00,0,26,12,3,41
15/10/15 3:00,0,26,3,8,37
15/10/15 4:00,0,20,11,5,36
15/10/15 5:00,0,41,11,10,62
15/10/15 6:00,0,95,13,6,114
15/10/15 7:00,0,174,28,18,220
15/10/15 8:00,0,261,17,12,290
15/10/15 9:00,3,317,18,16,354
15/10/15 10:00,1,263,17,26,307
15/10/15 11:00,0,281,17,21,319
15/10/15 12:00,6,292,22,26,346
15/10/15 13:00,3,275,18,35,331
15/10/15 14:00,2,310,16,34,362
15/10/15 15:00,4,310,20,37,371
15/10/15 16:00,2,317,21,19,359
15/10/15 17:00,0,313,13,19,345
15/10/15 18:00,0,288,21,22,331
15/10/15 19:00,1,222,18,17,258
15/10/15 20:00,0,182,5,17,204
15/10/15 21:00,0,150,21,9,180
15/10/15 22:00,0,110,12,13,135
15/10/15 23:00,0,66,9,17,92
16/10/15 0:00,0,51,10,3,64
16/10/15 1:00,0,39,8,6,53
16/10/15 2:00,0,31,4,6,41
16/10/15 3:00,0,34,4,8,46
16/10/15 4:00,0,29,9,7,45
16/10/15 5:00,0,33,11,12,56
16/10/15 6:00,0,92,18,13,123
16/10/15 7:00,0,139,19,7,165
16/10/15 8:00,1,220,9,22,252
16/10/15 9:00,0,266,13,16,295
16/10/15 10:00,2,287,22,18,329
16/10/15 11:00,2,294,14,24,334
16/10/15 12:00,2,321,15,17,355
16/10/15 13:00,4,380,18,26,428
16/10/15 14:00,0,367,16,22,405
16/10/15 15:00,1,449,14,25,489
16/10/15 16:00,4,504,23,30,561
16/10/15 17:00,3,544,17,14,578
16/10/15 18:00,0,440,23,17,480
16/10/15 19:00,1,349,17,12,379
16/10/15 20:00,1,271,11,17,300
16/10/15 21:00,1,177,15,16,209
16/10/15 22:00,0,146,17,9,172
16/10/15 23:00,0,115,8,9,132
17/10/15 0:00,0,60,11,5,76
17/10/15 1:00,0,43,5,6,54
17/10/15 2:00,0,31,5,6,42
17/10/15 3:00,0,43,8,3,54
17/10/15 4:00,0,41,6,9,56
17/10/15 5:00,0,43,8,5,56
17/10/15 6:00,0,126,14,3,143
17/10/15 7:00,0,142,12,9,163
17/10/15 8:00,1,239,26,30,296
17/10/15 9:00,1,274,29,14,318
17/10/15 10:00,4,340,24,10,378
17/10/15 11:00,1,364,14,17,396
17/10/15 12:00,4,377,14,28,423
17/10/15 13:00,1,322,11,22,356
17/10/15 14:00,3,314,13,23,353
17/10/15 15:00,4,346,11,18,379
17/10/15 16:00,3,323,14,16,356
17/10/15 17:00,2,387,13,9,411
17/10/15 18:00,3,373,18,8,402
17/10/15 19:00,0,319,33,6,358
17/10/15 20:00,5,269,20,8,302
17/10/15 21:00,0,182,11,7,200
17/10/15 22:00,0,131,7,4,142
17/10/15 23:00,0,107,12,4,123
18/10/15 0:00,0,102,10,5,117
18/10/15 1:00,0,71,4,4,79
18/10/15 2:00,2,56,7,5,70
18/10/15 3:00,0,24,7,2,33
18/10/15 4:00,0,29,4,3,36
18/10/15 5:00,0,45,5,11,61
18/10/15 6:00,0,61,4,3,68
18/10/15 7:00,0,95,6,6,107
18/10/15 8:00,4,181,10,12,207
18/10/15 9:00,1,241,15,6,263
18/10/15 10:00,0,279,19,10,308
18/10/15 11:00,7,351,10,10,378
18/10/15 12:00,3,365,14,12,394
18/10/15 13:00,1,354,11,22,388
18/10/15 14:00,0,413,19,25,457
18/10/15 15:00,2,438,14,22,476
18/10/15 16:00,1,558,18,26,603
18/10/15 17:00,10,595,16,22,643
18/10/15 18:00,4,573,19,22,618
18/10/15 19:00,2,527,19,10,558
18/10/15 20:00,2,356,23,10,391
18/10/15 21:00,0,259,19,6,284
18/10/15 22:00,0,170,20,10,200
18/10/15 23:00,0,101,16,13,130
19/10/15 0:00,0,89,9,4,102
19/10/15 1:00,0,51,11,8,70
19/10/15 2:00,0,24,4,1,29
19/10/15 3:00,0,30,4,11,45
19/10/15 4:00,0,28,9,6,43
19/10/15 5:00,0,51,5,11,67
19/10/15 6:00,0,121,11,13,145
19/10/15 7:00,0,205,17,5,227
19/10/15 8:00,0,246,8,12,266
19/10/15 9:00,0,294,22,24,340
19/10/15 10:00,1,310,23,12,346
19/10/15 11:00,4,246,15,31,296
19/10/15 12:00,1,265,23,31,320
19/10/15 13:00,3,239,19,21,282
19/10/15 14:00,0,240,13,26,279
19/10/15 15:00,3,284,18,32,337
19/10/15 16:00,0,285,21,19,325
19/10/15 17:00,0,268,19,23,310
19/10/15 18:00,1,245,16,30,292
19/10/15 19:00,0,169,19,20,208
19/10/15 20:00,0,167,6,21,194
19/10/15 21:00,0,132,15,19,166
19/10/15 22:00,0,95,14,14,123
19/10/15 23:00,0,59,8,14,81
20/10/15 0:00,0,50,9,8,67
20/10/15 1:00,0,34,8,4,46
20/10/15 2:00,0,25,5,7,37
20/10/15 3:00,0,25,6,4,35
20/10/15 4:00,0,19,15,5,39
20/10/15 5:00,0,42,17,11,70
20/10/15 6:00,0,91,10,12,113
20/10/15 7:00,0,158,15,12,185
20/10/15 8:00,0,251,16,12,279
20/10/15 9:00,0,308,19,17,344
20/10/15 10:00,2,270,18,24,314
20/10/15 11:00,1,235,19,28,283
20/10/15 12:00,1,204,14,28,247
20/10/15 13:00,0,255,26,24,305
20/10/15 14:00,0,241,18,36,295
20/10/15 15:00,0,257,20,22,299
20/10/15 16:00,1,274,16,16,307
20/10/15 17:00,1,235,17,23,276
20/10/15 18:00,2,217,12,24,255
20/10/15 19:00,1,180,13,18,212
20/10/15 20:00,1,158,9,19,187
20/10/15 21:00,0,112,13,13,138
20/10/15 22:00,0,103,19,20,142
20/10/15 23:00,0,78,10,8,96
21/10/15 0:00,0,39,7,15,61
21/10/15 1:00,0,32,10,6,48
21/10/15 2:00,0,15,6,6,27
21/10/15 3:00,0,21,8,7,36
21/10/15 4:00,0,19,12,6,37
21/10/15 5:00,0,34,9,11,54
21/10/15 6:00,0,74,18,24,116
21/10/15 7:00,0,136,21,14,171
21/10/15 8:00,0,218,14,16,248
21/10/15 9:00,1,245,18,14,278
21/10/15 10:00,0,279,17,24,320
21/10/15 11:00,1,231,29,21,282
21/10/15 12:00,1,224,17,22,264
21/10/15 13:00,0,252,19,24,295
21/10/15 14:00,0,229,14,29,272
21/10/15 15:00,2,281,22,22,327
21/10/15 16:00,0,282,20,17,319
21/10/15 17:00,2,282,20,28,332
21/10/15 18:00,0,219,17,22,258
21/10/15 19:00,0,190,18,20,228
21/10/15 20:00,0,194,40,17,251
21/10/15 21:00,1,131,18,19,169
21/10/15 22:00,0,87,10,19,116
21/10/15 23:00,0,68,13,16,97
22/10/15 0:00,0,48,23,7,78
22/10/15 1:00,0,33,12,10,55
22/10/15 2:00,0,22,7,6,35
22/10/15 3:00,0,21,7,9,37
22/10/15 4:00,0,24,10,4,38
22/10/15 5:00,0,35,11,10,56
22/10/15 6:00,0,74,15,13,102
22/10/15 7:00,0,146,22,13,181
22/10/15 8:00,0,214,13,21,248
22/10/15 9:00,0,273,12,10,295
22/10/15 10:00,0,260,22,23,305
22/10/15 11:00,0,240,19,30,289
22/10/15 12:00,3,225,17,20,265
22/10/15 13:00,2,272,17,47,338
22/10/15 14:00,0,290,13,28,331
22/10/15 15:00,0,297,16,33,346
22/10/15 16:00,0,309,22,28,359
22/10/15 17:00,0,278,16,24,318
22/10/15 18:00,0,261,17,15,293
22/10/15 19:00,0,181,18,18,217
22/10/15 20:00,0,152,7,17,176
22/10/15 21:00,0,122,15,8,145
22/10/15 22:00,0,85,8,21,114
22/10/15 23:00,0,65,26,8,99
23/10/15 0:00,0,56,11,13,80
23/10/15 1:00,0,42,8,7,57
23/10/15 2:00,0,40,3,5,48
23/10/15 3:00,0,26,6,4,36
23/10/15 4:00,0,36,5,9,50
23/10/15 5:00,0,31,12,9,52
23/10/15 6:00,0,75,11,8,94
23/10/15 7:00,0,128,12,15,155
23/10/15 8:00,0,202,10,13,225
23/10/15 9:00,0,203,10,16,229
23/10/15 10:00,1,296,12,23,332
23/10/15 11:00,0,293,23,18,334
23/10/15 12:00,0,306,17,28,351
23/10/15 13:00,0,339,17,49,405
23/10/15 14:00,2,346,23,29,400
23/10/15 15:00,1,448,11,23,483
23/10/15 16:00,0,495,23,15,533
23/10/15 17:00,1,511,20,26,558
23/10/15 18:00,1,425,20,15,461
23/10/15 19:00,1,335,17,12,365
23/10/15 20:00,1,250,14,8,273
23/10/15 21:00,2,202,17,10,231
23/10/15 22:00,0,131,9,12,152
23/10/15 23:00,0,89,12,10,111
24/10/15 0:00,0,73,10,5,88
24/10/15 1:00,0,50,7,2,59
24/10/15 2:00,0,36,7,3,46
24/10/15 3:00,0,27,5,9,41
24/10/15 4:00,0,34,5,4,43
24/10/15 5:00,0,46,3,4,53
24/10/15 6:00,0,57,9,1,67
24/10/15 7:00,0,143,15,6,164
24/10/15 8:00,0,219,25,5,249
24/10/15 9:00,5,321,14,16,356
24/10/15 10:00,5,386,16,15,422
24/10/15 11:00,2,479,13,11,505
24/10/15 12:00,2,440,5,22,469
24/10/15 13:00,2,431,7,33,473
24/10/15 14:00,4,392,13,23,432
24/10/15 15:00,3,350,13,24,390
24/10/15 16:00,1,415,15,13,444
24/10/15 17:00,1,385,16,8,410
24/10/15 18:00,2,316,14,16,348
24/10/15 19:00,0,230,14,13,257
24/10/15 20:00,2,239,24,9,274
24/10/15 21:00,0,170,13,8,191
24/10/15 22:00,0,128,8,2,138
24/10/15 23:00,0,77,11,1,89
25/10/15 0:00,0,76,4,3,83
25/10/15 1:00,0,48,4,1,53
25/10/15 2:00,1,33,3,6,43
25/10/15 3:00,0,60,15,5,80
25/10/15 4:00,0,22,5,8,35
25/10/15 5:00,0,30,3,1,34
25/10/15 6:00,0,53,7,4,64
25/10/15 7:00,1,104,8,3,116
25/10/15 8:00,0,161,12,9,182
25/10/15 9:00,1,283,11,16,311
25/10/15 10:00,0,339,10,12,361
25/10/15 11:00,1,333,13,16,363
25/10/15 12:00,3,361,7,17,388
25/10/15 13:00,4,345,14,15,378
25/10/15 14:00,2,357,10,11,380
25/10/15 15:00,3,425,19,19,466
25/10/15 16:00,3,462,12,23,500
25/10/15 17:00,1,467,15,13,496
25/10/15 18:00,1,440,17,16,474
25/10/15 19:00,4,340,13,13,370
25/10/15 20:00,1,255,11,5,272
25/10/15 21:00,0,188,19,11,218
25/10/15 22:00,0,130,16,6,152
25/10/15 23:00,0,135,13,12,160
26/10/15 0:00,0,68,10,9,87
26/10/15 1:00,0,23,10,6,39
26/10/15 2:00,0,28,5,4,37
26/10/15 3:00,0,24,1,5,30
26/10/15 4:00,0,38,7,8,53
26/10/15 5:00,0,44,5,4,53
26/10/15 6:00,0,85,14,17,116
26/10/15 7:00,0,148,12,7,167
26/10/15 8:00,0,173,4,11,188
26/10/15 9:00,1,218,19,15,253
26/10/15 10:00,0,255,11,27,293
26/10/15 11:00,0,289,12,19,320
26/10/15 12:00,2,297,11,16,326
26/10/15 13:00,1,273,15,19,308
26/10/15 14:00,1,261,10,28,300
26/10/15 15:00,0,301,10,27,338
26/10/15 16:00,0,341,16,16,373
26/10/15 17:00,1,326,15,16,358
26/10/15 18:00,0,317,19,17,353
26/10/15 19:00,0,298,10,16,324
26/10/15 20:00,0,155,7,12,174
26/10/15 21:00,0,138,11,14,163
26/10/15 22:00,0,98,16,14,128
26/10/15 23:00,0,58,5,4,67
27/10/15 0:00,0,47,8,9,64
27/10/15 1:00,0,41,9,4,54
27/10/15 2:00,0,16,6,5,27
27/10/15 3:00,0,24,4,6,34
27/10/15 4:00,0,24,5,4,33
27/10/15 5:00,0,53,10,12,75
27/10/15 6:00,0,86,17,14,117
27/10/15 7:00,0,135,11,13,159
27/10/15 8:00,0,176,14,13,203
27/10/15 9:00,1,211,12,15,239
27/10/15 10:00,0,239,21,26,286
27/10/15 11:00,2,242,10,29,283
27/10/15 12:00,1,240,14,29,284
27/10/15 13:00,5,268,18,21,312
27/10/15 14:00,0,228,16,23,267
27/10/15 15:00,0,302,21,26,349
27/10/15 16:00,1,324,11,23,359
27/10/15 17:00,0,291,14,29,334
27/10/15 18:00,1,291,15,25,332
27/10/15 19:00,2,210,14,18,244
27/10/15 20:00,3,187,8,14,212
27/10/15 21:00,0,140,12,6,158
27/10/15 22:00,0,98,7,2,107
27/10/15 23:00,0,58,4,4,66
28/10/15 0:00,0,49,4,6,59
28/10/15 1:00,0,36,7,4,47
28/10/15 2:00,0,17,2,4,23
28/10/15 3:00,0,14,2,0,16
28/10/15 4:00,0,19,3,6,28
28/10/15 5:00,0,20,2,7,29
28/10/15 6:00,0,56,2,4,62
28/10/15 7:00,0,84,17,8,109
28/10/15 8:00,0,141,9,7,157
28/10/15 9:00,2,198,9,13,222
28/10/15 10:00,0,239,9,5,253
28/10/15 11:00,2,247,11,7,267
28/10/15 12:00,0,259,14,19,292
28/10/15 13:00,2,247,6,11,266
28/10/15 14:00,4,270,7,17,298
28/10/15 15:00,3,337,8,13,361
28/10/15 16:00,3,351,12,11,377
28/10/15 17:00,0,410,22,20,452
28/10/15 18:00,3,392,26,11,432
28/10/15 19:00,10,334,18,11,373
28/10/15 20:00,0,281,21,10,312
28/10/15 21:00,2,184,32,22,240
28/10/15 22:00,1,108,11,5,125
28/10/15 23:00,0,72,7,10,89
29/10/15 0:00,1,61,9,5,76
29/10/15 1:00,0,41,12,4,57
29/10/15 2:00,0,26,7,4,37
29/10/15 3:00,0,28,5,4,37
29/10/15 4:00,0,27,11,8,46
29/10/15 5:00,0,51,15,9,75
29/10/15 6:00,0,129,18,11,158
29/10/15 7:00,1,199,24,11,235
29/10/15 8:00,1,313,11,12,337
29/10/15 9:00,2,289,22,20,333
29/10/15 10:00,0,300,27,26,353
29/10/15 11:00,0,284,18,29,331
29/10/15 12:00,1,280,21,30,332
29/10/15 13:00,1,258,24,37,320
29/10/15 14:00,2,285,17,36,340
29/10/15 15:00,2,290,14,32,338
29/10/15 16:00,1,268,19,36,324
29/10/15 17:00,4,244,22,21,291
29/10/15 18:00,1,231,25,18,275
29/10/15 19:00,0,178,15,13,206
29/10/15 20:00,0,162,18,26,206
29/10/15 21:00,0,127,25,14,166
29/10/15 22:00,0,92,15,12,119
29/10/15 23:00,2,58,8,12,80
30/10/15 0:00,0,44,12,19,75
30/10/15 1:00,0,25,5,5,35
30/10/15 2:00,0,26,5,6,37
30/10/15 3:00,0,25,3,6,34
30/10/15 4:00,1,26,9,4,40
30/10/15 5:00,0,36,10,11,57
30/10/15 6:00,0,65,7,13,85
30/10/15 7:00,0,134,23,14,171
30/10/15 8:00,1,230,10,12,253
30/10/15 9:00,0,250,13,13,276
30/10/15 10:00,1,305,28,23,357
30/10/15 11:00,1,264,24,37,326
30/10/15 12:00,1,301,11,33,346
30/10/15 13:00,1,305,20,24,350
30/10/15 14:00,1,357,16,15,389
30/10/15 15:00,4,379,18,22,423
30/10/15 16:00,4,449,17,21,491
30/10/15 17:00,6,432,15,17,470
30/10/15 18:00,0,384,24,19,427
30/10/15 19:00,0,310,17,16,343
30/10/15 20:00,0,235,16,12,263
30/10/15 21:00,0,160,11,15,186
30/10/15 22:00,2,112,9,12,135
30/10/15 23:00,1,84,22,11,118
31/10/15 0:00,0,48,11,11,70
31/10/15 1:00,0,46,5,5,56
31/10/15 2:00,0,23,3,6,32
31/10/15 3:00,0,31,6,7,44
31/10/15 4:00,0,24,5,1,30
31/10/15 5:00,0,40,5,6,51
31/10/15 6:00,0,72,5,0,77
31/10/15 7:00,0,137,12,5,154
31/10/15 8:00,1,207,13,15,236
31/10/15 9:00,0,248,16,15,279
31/10/15 10:00,2,298,16,13,329
31/10/15 11:00,0,321,10,12,343
31/10/15 12:00,0,316,18,17,351
31/10/15 13:00,2,295,17,17,331
31/10/15 14:00,4,295,11,11,321
31/10/15 15:00,0,310,12,18,340
31/10/15 16:00,1,331,14,20,366
31/10/15 17:00,0,341,14,14,369
31/10/15 18:00,3,262,13,10,288
31/10/15 19:00,5,227,12,9,253
31/10/15 20:00,1,184,5,4,194
31/10/15 21:00,1,147,7,7,162
31/10/15 22:00,0,79,14,6,99
31/10/15 23:00,0,67,6,8,81
1/11/15 0:00,0,74,6,8,88
1/11/15 1:00,0,52,10,2,64
1/11/15 2:00,0,71,9,1,81
1/11/15 3:00,0,78,25,1,104
1/11/15 4:00,0,32,8,2,42
1/11/15 5:00,0,26,4,2,32
1/11/15 6:00,0,59,3,3,65
1/11/15 7:00,1,113,7,4,125
1/11/15 8:00,0,167,10,8,185
1/11/15 9:00,1,227,8,12,248
1/11/15 10:00,0,297,12,16,325
1/11/15 11:00,0,388,17,12,417
1/11/15 12:00,1,339,11,14,365
1/11/15 13:00,1,380,19,20,420
1/11/15 14:00,2,434,21,21,478
1/11/15 15:00,5,416,15,27,463
1/11/15 16:00,4,499,21,19,543
1/11/15 17:00,12,593,16,19,640
1/11/15 18:00,3,567,19,14,603
1/11/15 19:00,5,471,17,14,507
1/11/15 20:00,3,326,14,6,349
1/11/15 21:00,1,253,25,11,290
1/11/15 22:00,0,182,20,16,218
1/11/15 23:00,0,93,8,8,109
2/11/15 0:00,0,48,9,7,64
2/11/15 1:00,0,38,8,6,52
2/11/15 2:00,0,31,6,8,45
2/11/15 3:00,0,29,3,5,37
2/11/15 4:00,0,26,9,4,39
2/11/15 5:00,0,49,7,8,64
2/11/15 6:00,0,134,9,9,152
2/11/15 7:00,0,251,14,12,277
2/11/15 8:00,2,287,12,11,312
2/11/15 9:00,0,282,17,14,313
2/11/15 10:00,2,300,14,16,332
2/11/15 11:00,0,288,14,26,328
2/11/15 12:00,2,235,17,24,278
2/11/15 13:00,1,266,13,20,300
2/11/15 14:00,0,246,15,22,283
2/11/15 15:00,2,274,13,19,308
2/11/15 16:00,1,289,12,28,330
2/11/15 17:00,0,319,12,17,348
2/11/15 18:00,1,232,13,28,274
2/11/15 19:00,0,213,11,21,245
2/11/15 20:00,0,178,6,16,200
2/11/15 21:00,0,150,13,15,178
2/11/15 22:00,0,103,10,11,124
2/11/15 23:00,0,51,8,9,68
3/11/15 0:00,0,57,7,12,76
3/11/15 1:00,0,31,6,8,45
3/11/15 2:00,0,26,6,8,40
3/11/15 3:00,0,19,6,6,31
3/11/15 4:00,0,24,10,9,43
3/11/15 5:00,0,33,7,10,50
3/11/15 6:00,0,85,7,22,114
3/11/15 7:00,1,185,19,12,217
3/11/15 8:00,0,249,9,16,274
3/11/15 9:00,0,288,18,16,322
3/11/15 10:00,1,272,14,26,313
3/11/15 11:00,1,235,11,32,279
3/11/15 12:00,0,230,10,32,272
3/11/15 13:00,0,237,20,24,281
3/11/15 14:00,2,220,11,23,256
3/11/15 15:00,1,258,17,25,301
3/11/15 16:00,0,243,10,14,267
3/11/15 17:00,0,231,11,25,267
3/11/15 18:00,0,204,11,22,237
3/11/15 19:00,0,173,17,22,212
3/11/15 20:00,0,111,10,14,135
3/11/15 21:00,0,122,18,12,152
3/11/15 22:00,0,100,11,16,127
3/11/15 23:00,1,53,8,15,77
4/11/15 0:00,0,31,8,12,51
4/11/15 1:00,0,29,7,2,38
4/11/15 2:00,0,15,7,9,31
4/11/15 3:00,0,28,3,4,35
4/11/15 4:00,0,23,8,7,38
4/11/15 5:00,0,39,6,9,54
4/11/15 6:00,0,86,12,13,111
4/11/15 7:00,0,159,11,15,185
4/11/15 8:00,0,188,12,13,213
4/11/15 9:00,0,285,16,20,321
4/11/15 10:00,1,282,22,32,337
4/11/15 11:00,0,223,12,22,257
4/11/15 12:00,0,218,19,31,268
4/11/15 13:00,2,222,16,24,264
4/11/15 14:00,1,230,14,23,268
4/11/15 15:00,0,275,14,31,320
4/11/15 16:00,0,246,16,14,276
4/11/15 17:00,1,254,13,24,292
4/11/15 18:00,0,235,18,27,280
4/11/15 19:00,0,211,16,16,243
4/11/15 20:00,1,137,13,17,168
4/11/15 21:00,0,120,13,13,146
4/11/15 22:00,0,91,15,14,120
4/11/15 23:00,0,51,10,4,65
5/11/15 0:00,0,33,5,12,50
5/11/15 1:00,0,23,7,4,34
5/11/15 2:00,0,29,7,9,45
5/11/15 3:00,0,23,5,7,35
5/11/15 4:00,0,20,7,6,33
5/11/15 5:00,0,38,7,7,52
5/11/15 6:00,0,69,18,15,102
5/11/15 7:00,0,126,15,17,158
5/11/15 8:00,0,217,18,16,251
5/11/15 9:00,0,249,10,16,275
5/11/15 10:00,0,281,15,28,324
5/11/15 11:00,0,265,14,24,303
5/11/15 12:00,0,215,18,24,257
5/11/15 13:00,0,224,13,25,262
5/11/15 14:00,1,280,22,26,329
5/11/15 15:00,1,268,20,29,318
5/11/15 16:00,3,311,18,28,360
5/11/15 17:00,0,262,22,20,304
5/11/15 18:00,0,233,15,25,273
5/11/15 19:00,0,239,12,17,268
5/11/15 20:00,0,162,8,21,191
5/11/15 21:00,0,124,12,19,155
5/11/15 22:00,0,84,18,20,122
5/11/15 23:00,0,70,7,18,95
6/11/15 0:00,0,49,9,15,73
6/11/15 1:00,0,30,7,6,43
6/11/15 2:00,0,36,4,6,46
6/11/15 3:00,0,30,6,7,43
6/11/15 4:00,0,29,6,8,43
6/11/15 5:00,0,44,6,13,63
6/11/15 6:00,0,88,14,20,122
6/11/15 7:00,1,147,15,21,184
6/11/15 8:00,0,214,11,19,244
6/11/15 9:00,1,257,17,19,294
6/11/15 10:00,1,232,18,30,281
6/11/15 11:00,0,279,17,28,324
6/11/15 12:00,1,272,18,33,324
6/11/15 13:00,2,326,18,40,386
6/11/15 14:00,2,331,18,29,380
6/11/15 15:00,0,439,26,20,485
6/11/15 16:00,3,498,15,27,543
6/11/15 17:00,2,508,19,23,552
6/11/15 18:00,1,410,16,20,447
6/11/15 19:00,0,331,20,15,366
6/11/15 20:00,0,279,14,15,308
6/11/15 21:00,0,182,20,10,212
6/11/15 22:00,0,124,11,11,146
6/11/15 23:00,0,115,7,8,130
7/11/15 0:00,0,45,9,11,65
7/11/15 1:00,0,49,7,6,62
7/11/15 2:00,0,34,9,3,46
7/11/15 3:00,0,30,7,4,41
7/11/15 4:00,0,53,19,4,76
7/11/15 5:00,0,35,11,7,53
7/11/15 6:00,0,103,4,9,116
7/11/15 7:00,0,143,18,10,171
7/11/15 8:00,0,249,12,9,270
7/11/15 9:00,2,290,16,17,325
7/11/15 10:00,1,337,18,17,373
7/11/15 11:00,4,378,13,16,411
7/11/15 12:00,1,341,15,13,370
7/11/15 13:00,2,305,14,18,339
7/11/15 14:00,3,271,9,14,297
7/11/15 15:00,0,289,8,13,310
7/11/15 16:00,2,329,15,16,362
7/11/15 17:00,6,369,16,16,407
7/11/15 18:00,3,300,9,11,323
7/11/15 19:00,2,309,14,25,350
7/11/15 20:00,5,200,14,10,229
7/11/15 21:00,0,172,14,11,197
7/11/15 22:00,0,111,22,7,140
7/11/15 23:00,0,87,10,2,99
8/11/15 0:00,0,52,7,5,64
8/11/15 1:00,0,36,8,5,49
8/11/15 2:00,0,24,4,1,29
8/11/15 3:00,0,21,8,4,33
8/11/15 4:00,0,32,6,4,42
8/11/15 5:00,0,28,9,5,42
8/11/15 6:00,0,52,3,10,65
8/11/15 7:00,0,126,7,4,137
8/11/15 8:00,1,197,11,9,218
8/11/15 9:00,1,228,21,5,255
8/11/15 10:00,1,262,23,7,293
8/11/15 11:00,6,324,14,16,360
8/11/15 12:00,3,318,19,20,360
8/11/15 13:00,1,356,9,26,392
8/11/15 14:00,1,361,16,24,402
8/11/15 15:00,2,411,14,32,459
8/11/15 16:00,3,465,14,29,511
8/11/15 17:00,0,516,20,21,557
8/11/15 18:00,1,514,18,21,554
8/11/15 19:00,2,385,15,16,418
8/11/15 20:00,1,338,15,8,362
8/11/15 21:00,0,262,40,11,313
8/11/15 22:00,1,185,16,6,208
8/11/15 23:00,0,99,15,8,122
9/11/15 0:00,0,72,14,11,97
9/11/15 1:00,0,38,9,5,52
9/11/15 2:00,0,30,5,10,45
9/11/15 3:00,0,19,7,6,32
9/11/15 4:00,0,34,10,4,48
9/11/15 5:00,1,52,12,9,74
9/11/15 6:00,1,128,11,11,151
9/11/15 7:00,0,239,14,16,269
9/11/15 8:00,0,248,9,8,265
9/11/15 9:00,2,271,17,21,311
9/11/15 10:00,1,290,17,33,341
9/11/15 11:00,1,267,16,40,324
9/11/15 12:00,0,228,14,27,269
9/11/15 13:00,1,246,10,29,286
9/11/15 14:00,2,245,16,29,292
9/11/15 15:00,0,270,17,19,306
9/11/15 16:00,0,283,19,26,328
9/11/15 17:00,1,261,30,22,314
9/11/15 18:00,0,233,24,37,294
9/11/15 19:00,0,189,12,24,225
9/11/15 20:00,0,154,8,14,176
9/11/15 21:00,0,130,19,21,170
9/11/15 22:00,0,95,12,13,120
9/11/15 23:00,0,45,7,4,56
10/11/15 0:00,1,42,8,5,56
10/11/15 1:00,0,29,8,14,51
10/11/15 2:00,0,20,3,7,30
10/11/15 3:00,0,30,19,6,55
10/11/15 4:00,0,13,13,4,30
10/11/15 5:00,0,29,10,13,52
10/11/15 6:00,0,76,15,20,111
10/11/15 7:00,0,195,7,12,214
10/11/15 8:00,0,226,15,17,258
10/11/15 9:00,0,270,13,14,297
10/11/15 10:00,0,242,17,24,283
10/11/15 11:00,2,225,24,20,271
10/11/15 12:00,0,224,13,18,255
10/11/15 13:00,2,236,25,31,294
10/11/15 14:00,2,233,13,23,271
10/11/15 15:00,0,266,21,27,314
10/11/15 16:00,3,251,12,23,289
10/11/15 17:00,0,260,12,20,292
10/11/15 18:00,0,203,16,26,245
10/11/15 19:00,1,200,12,17,230
10/11/15 20:00,0,158,7,15,180
10/11/15 21:00,0,109,13,13,135
10/11/15 22:00,0,106,21,11,138
10/11/15 23:00,0,66,9,8,83
11/11/15 0:00,0,41,6,14,61
11/11/15 1:00,0,31,8,8,47
11/11/15 2:00,0,18,6,1,25
11/11/15 3:00,0,30,11,8,49
11/11/15 4:00,0,25,8,11,44
11/11/15 5:00,0,41,13,12,66
11/11/15 6:00,0,83,15,23,121
11/11/15 7:00,0,167,17,16,200
11/11/15 8:00,0,211,20,15,246
11/11/15 9:00,1,253,16,20,290
11/11/15 10:00,0,271,21,24,316
11/11/15 11:00,1,233,17,33,284
11/11/15 12:00,0,231,21,39,291
11/11/15 13:00,1,252,16,36,305
11/11/15 14:00,2,248,19,32,301
11/11/15 15:00,1,308,16,33,358
11/11/15 16:00,2,315,15,24,356
11/11/15 17:00,0,284,13,26,323
11/11/15 18:00,0,266,15,24,305
11/11/15 19:00,0,228,11,20,259
11/11/15 20:00,1,183,21,13,218
11/11/15 21:00,0,117,23,9,149
11/11/15 22:00,0,100,12,16,128
11/11/15 23:00,0,73,11,13,97
12/11/15 0:00,0,55,11,4,70
12/11/15 1:00,0,40,8,6,54
12/11/15 2:00,0,32,5,8,45
12/11/15 3:00,0,26,6,9,41
12/11/15 4:00,0,34,10,7,51
12/11/15 5:00,0,30,16,15,61
12/11/15 6:00,0,97,18,21,136
12/11/15 7:00,0,144,20,6,170
12/11/15 8:00,1,244,16,16,277
12/11/15 9:00,0,270,24,9,303
12/11/15 10:00,2,284,11,20,317
12/11/15 11:00,2,221,18,23,264
12/11/15 12:00,0,254,17,28,299
12/11/15 13:00,1,264,14,35,314
12/11/15 14:00,1,271,21,20,313
12/11/15 15:00,2,294,14,43,353
12/11/15 16:00,1,313,18,28,360
12/11/15 17:00,0,266,15,26,307
12/11/15 18:00,0,266,19,15,300
12/11/15 19:00,0,198,13,9,220
12/11/15 20:00,0,140,9,14,163
12/11/15 21:00,0,145,16,17,178
12/11/15 22:00,0,103,8,11,122
12/11/15 23:00,0,72,6,16,94
13/11/15 0:00,0,54,12,8,74
13/11/15 1:00,0,27,7,7,41
13/11/15 2:00,0,26,8,6,40
13/11/15 3:00,1,32,3,5,41
13/11/15 4:00,0,32,13,9,54
13/11/15 5:00,0,49,7,12,68
13/11/15 6:00,0,118,22,12,152
13/11/15 7:00,0,213,27,19,259
13/11/15 8:00,1,318,10,15,344
13/11/15 9:00,1,301,17,17,336
13/11/15 10:00,1,291,19,22,333
13/11/15 11:00,1,277,16,37,331
13/11/15 12:00,1,287,23,33,344
13/11/15 13:00,2,317,20,39,378
13/11/15 14:00,0,448,18,47,513
13/11/15 15:00,2,536,11,15,564
13/11/15 16:00,1,515,23,23,562
13/11/15 17:00,2,538,18,17,575
13/11/15 18:00,1,446,18,16,481
13/11/15 19:00,1,399,16,13,429
13/11/15 20:00,1,251,14,16,282
13/11/15 21:00,0,207,21,11,239
13/11/15 22:00,0,144,21,8,173
13/11/15 23:00,0,95,8,1,104
14/11/15 0:00,1,74,12,9,96
14/11/15 1:00,0,38,9,2,49
14/11/15 2:00,0,22,8,4,34
14/11/15 3:00,0,28,7,5,40
14/11/15 4:00,0,43,2,4,49
14/11/15 5:00,0,41,6,3,50
14/11/15 6:00,0,75,6,2,83
14/11/15 7:00,0,117,16,10,143
14/11/15 8:00,0,188,11,10,209
14/11/15 9:00,1,299,14,7,321
14/11/15 10:00,0,363,14,16,393
14/11/15 11:00,1,323,11,17,352
14/11/15 12:00,0,384,18,18,420
14/11/15 13:00,3,330,8,13,354
14/11/15 14:00,3,284,11,13,311
14/11/15 15:00,2,279,11,16,308
14/11/15 16:00,2,329,15,15,361
14/11/15 17:00,4,325,16,10,355
14/11/15 18:00,0,345,13,15,373
14/11/15 19:00,1,304,14,9,328
14/11/15 20:00,0,196,19,11,226
14/11/15 21:00,2,156,6,4,168
14/11/15 22:00,0,115,8,3,126
14/11/15 23:00,0,79,9,3,91
15/11/15 0:00,0,59,8,7,74
15/11/15 1:00,1,48,11,3,63
15/11/15 2:00,0,31,9,3,43
15/11/15 3:00,0,34,6,5,45
15/11/15 4:00,0,22,5,1,28
15/11/15 5:00,0,26,7,7,40
15/11/15 6:00,0,64,4,6,74
15/11/15 7:00,0,103,6,4,113
15/11/15 8:00,0,139,16,11,166
15/11/15 9:00,0,200,8,8,216
15/11/15 10:00,2,276,11,7,296
15/11/15 11:00,4,309,13,14,340
15/11/15 12:00,6,332,14,22,374
15/11/15 13:00,4,323,15,23,365
15/11/15 14:00,0,393,12,14,419
15/11/15 15:00,2,425,11,18,456
15/11/15 16:00,1,536,19,32,588
15/11/15 17:00,1,539,13,15,568
15/11/15 18:00,2,515,18,26,561
15/11/15 19:00,0,407,21,7,435
15/11/15 20:00,0,294,11,7,312
15/11/15 21:00,2,183,16,15,216
15/11/15 22:00,0,150,16,11,177
15/11/15 23:00,0,86,15,8,109
16/11/15 0:00,0,61,10,7,78
16/11/15 1:00,0,49,3,9,61
16/11/15 2:00,0,22,5,2,29
16/11/15 3:00,0,27,10,5,42
16/11/15 4:00,0,35,6,2,43
16/11/15 5:00,0,59,22,10,91
16/11/15 6:00,0,115,11,11,137
16/11/15 7:00,0,229,13,15,257
16/11/15 8:00,0,279,11,8,298
16/11/15 9:00,2,274,13,13,302
16/11/15 10:00,0,280,24,21,325
16/11/15 11:00,0,208,14,39,261
16/11/15 12:00,1,248,7,23,279
16/11/15 13:00,0,224,14,28,266
16/11/15 14:00,2,236,13,22,273
16/11/15 15:00,0,246,10,20,276
16/11/15 16:00,0,262,12,20,294
16/11/15 17:00,1,249,15,25,290
16/11/15 18:00,0,205,15,19,239
16/11/15 19:00,0,190,13,24,227
16/11/15 20:00,1,135,6,18,160
16/11/15 21:00,0,125,12,18,155
16/11/15 22:00,0,77,12,18,107
16/11/15 23:00,0,63,9,8,80
17/11/15 0:00,0,31,10,5,46
17/11/15 1:00,0,36,7,5,48
17/11/15 2:00,0,17,3,2,22
17/11/15 3:00,0,21,6,4,31
17/11/15 4:00,0,9,10,9,28
17/11/15 5:00,0,29,7,14,50
17/11/15 6:00,0,72,10,21,103
17/11/15 7:00,0,180,12,11,203
17/11/15 8:00,0,227,5,13,245
17/11/15 9:00,1,310,15,12,338
17/11/15 10:00,2,232,12,19,265
17/11/15 11:00,0,227,13,26,266
17/11/15 12:00,0,227,15,26,268
17/11/15 13:00,2,273,16,34,325
17/11/15 14:00,1,225,13,26,265
17/11/15 15:00,0,239,12,18,269
17/11/15 16:00,3,274,17,21,315
17/11/15 17:00,1,262,14,18,295
17/11/15 18:00,0,231,12,18,261
17/11/15 19:00,0,188,14,17,219
17/11/15 20:00,0,140,9,10,159
17/11/15 21:00,0,111,11,13,135
17/11/15 22:00,1,71,10,13,95
17/11/15 23:00,0,63,7,18,88
18/11/15 0:00,0,44,11,7,62
18/11/15 1:00,0,18,6,3,27
18/11/15 2:00,1,29,7,6,43
18/11/15 3:00,0,27,5,5,37
18/11/15 4:00,0,24,6,2,32
18/11/15 5:00,0,36,10,15,61
18/11/15 6:00,0,87,12,19,118
18/11/15 7:00,0,169,21,13,203
18/11/15 8:00,0,239,12,12,263
18/11/15 9:00,1,260,13,11,285
18/11/15 10:00,2,244,17,25,288
18/11/15 11:00,0,218,22,30,270
18/11/15 12:00,2,244,14,19,279
18/11/15 13:00,5,222,19,46,292
18/11/15 14:00,4,253,10,27,294
18/11/15 15:00,0,303,16,29,348
18/11/15 16:00,1,280,20,21,322
18/11/15 17:00,0,285,15,15,315
18/11/15 18:00,1,263,14,17,295
18/11/15 19:00,1,208,26,16,251
18/11/15 20:00,0,175,11,23,209
18/11/15 21:00,0,135,16,16,167
18/11/15 22:00,0,89,12,21,122
18/11/15 23:00,0,63,8,12,83
19/11/15 0:00,0,37,9,12,58
19/11/15 1:00,0,30,8,7,45
19/11/15 2:00,0,13,5,4,22
19/11/15 3:00,0,26,8,8,42
19/11/15 4:00,0,15,10,7,32
19/11/15 5:00,0,43,18,10,71
19/11/15 6:00,0,88,7,17,112
19/11/15 7:00,0,149,18,12,179
19/11/15 8:00,0,208,16,15,239
19/11/15 9:00,1,319,15,15,350
19/11/15 10:00,1,284,18,20,323
19/11/15 11:00,1,239,23,21,284
19/11/15 12:00,0,229,13,19,261
19/11/15 13:00,1,241,18,34,294
19/11/15 14:00,2,277,16,21,316
19/11/15 15:00,1,267,19,23,310
19/11/15 16:00,0,306,16,26,348
19/11/15 17:00,1,300,17,22,340
19/11/15 18:00,0,263,13,20,296
19/11/15 19:00,0,224,17,21,262
19/11/15 20:00,0,142,7,17,166
19/11/15 21:00,0,115,17,17,149
19/11/15 22:00,0,96,14,9,119
19/11/15 23:00,0,62,7,10,79
20/11/15 0:00,0,35,7,4,46
20/11/15 1:00,0,26,5,7,38
20/11/15 2:00,0,27,7,1,35
20/11/15 3:00,0,25,6,5,36
20/11/15 4:00,0,20,6,8,34
20/11/15 5:00,0,33,10,15,58
20/11/15 6:00,0,67,12,13,92
20/11/15 7:00,0,164,13,8,185
20/11/15 8:00,0,189,18,11,218
20/11/15 9:00,0,241,12,14,267
20/11/15 10:00,1,266,18,27,312
20/11/15 11:00,0,282,12,26,320
20/11/15 12:00,2,276,22,25,325
20/11/15 13:00,3,304,10,30,347
20/11/15 14:00,2,354,20,37,413
20/11/15 15:00,1,424,15,22,462
20/11/15 16:00,3,460,15,22,500
20/11/15 17:00,0,465,11,21,497
20/11/15 18:00,3,352,18,16,389
20/11/15 19:00,0,341,19,17,377
20/11/15 20:00,2,211,17,12,242
20/11/15 21:00,1,190,16,10,217
20/11/15 22:00,1,133,14,9,157
20/11/15 23:00,0,77,15,5,97
21/11/15 0:00,0,46,9,12,67
21/11/15 1:00,0,36,9,7,52
21/11/15 2:00,0,32,6,4,42
21/11/15 3:00,0,27,7,5,39
21/11/15 4:00,0,35,7,9,51
21/11/15 5:00,0,48,7,3,58
21/11/15 6:00,0,81,7,2,90
21/11/15 7:00,0,128,15,7,150
21/11/15 8:00,0,205,8,4,217
21/11/15 9:00,0,274,20,18,312
21/11/15 10:00,0,326,21,18,365
21/11/15 11:00,0,318,11,22,351
21/11/15 12:00,0,294,7,17,318
21/11/15 13:00,1,286,10,24,321
21/11/15 14:00,2,281,11,17,311
21/11/15 15:00,0,307,12,10,329
21/11/15 16:00,1,273,21,21,316
21/11/15 17:00,0,285,18,11,314
21/11/15 18:00,0,270,14,4,288
21/11/15 19:00,0,248,21,5,274
21/11/15 20:00,0,166,16,6,188
21/11/15 21:00,1,140,12,2,155
21/11/15 22:00,0,90,3,2,95
21/11/15 23:00,0,59,11,1,71
22/11/15 0:00,0,55,9,2,66
22/11/15 1:00,0,44,3,1,48
22/11/15 2:00,0,19,6,1,26
22/11/15 3:00,0,25,5,1,31
22/11/15 4:00,0,28,6,0,34
22/11/15 5:00,0,30,2,2,34
22/11/15 6:00,0,55,13,1,69
22/11/15 7:00,0,104,5,1,110
22/11/15 8:00,0,134,6,5,145
22/11/15 9:00,0,184,12,10,206
22/11/15 10:00,0,233,16,14,263
22/11/15 11:00,0,279,14,14,307
22/11/15 12:00,2,280,13,6,301
22/11/15 13:00,1,340,19,13,373
22/11/15 14:00,2,321,14,22,359
22/11/15 15:00,4,367,9,18,398
22/11/15 16:00,0,444,17,19,480
22/11/15 17:00,3,509,17,12,541
22/11/15 18:00,4,453,19,16,492
22/11/15 19:00,0,350,15,17,382
22/11/15 20:00,1,251,15,15,282
22/11/15 21:00,0,200,17,13,230
22/11/15 22:00,0,116,8,3,127
22/11/15 23:00,1,113,13,7,134
23/11/15 0:00,0,71,12,4,87
23/11/15 1:00,0,26,6,3,35
23/11/15 2:00,0,35,3,3,41
23/11/15 3:00,0,17,7,4,28
23/11/15 4:00,0,23,6,5,34
23/11/15 5:00,0,50,8,15,73
23/11/15 6:00,0,137,11,7,155
23/11/15 7:00,0,210,12,14,236
23/11/15 8:00,1,267,6,14,288
23/11/15 9:00,0,272,12,9,293
23/11/15 10:00,0,254,17,18,289
23/11/15 11:00,0,255,12,44,311
23/11/15 12:00,0,228,11,24,263
23/11/15 13:00,0,239,12,40,291
23/11/15 14:00,0,228,8,30,266
23/11/15 15:00,0,261,12,18,291
23/11/15 16:00,0,250,11,23,284
23/11/15 17:00,3,265,12,28,308
23/11/15 18:00,0,211,12,14,237
23/11/15 19:00,0,180,9,20,209
23/11/15 20:00,0,138,8,22,168
23/11/15 21:00,0,100,11,7,118
23/11/15 22:00,0,88,7,9,104
23/11/15 23:00,0,58,7,6,71
24/11/15 0:00,0,37,13,12,62
24/11/15 1:00,0,31,6,3,40
24/11/15 2:00,0,18,3,2,23
24/11/15 3:00,0,16,9,4,29
24/11/15 4:00,0,22,7,6,35
24/11/15 5:00,0,31,9,10,50
24/11/15 6:00,1,104,12,18,135
24/11/15 7:00,0,171,11,12,194
24/11/15 8:00,0,243,9,7,259
24/11/15 9:00,0,284,10,19,313
24/11/15 10:00,1,210,17,20,248
24/11/15 11:00,0,251,12,23,286
24/11/15 12:00,0,204,13,36,253
24/11/15 13:00,0,218,15,30,263
24/11/15 14:00,0,241,12,43,296
24/11/15 15:00,0,259,10,16,285
24/11/15 16:00,1,279,17,16,313
24/11/15 17:00,1,240,9,14,264
24/11/15 18:00,0,204,15,19,238
24/11/15 19:00,0,150,9,22,181
24/11/15 20:00,0,126,8,16,150
24/11/15 21:00,0,108,16,17,141
24/11/15 22:00,0,78,10,13,101
24/11/15 23:00,0,49,6,9,64
25/11/15 0:00,0,36,8,11,55
25/11/15 1:00,0,21,7,3,31
25/11/15 2:00,0,16,3,5,24
25/11/15 3:00,0,19,7,1,27
25/11/15 4:00,0,26,7,10,43
25/11/15 5:00,0,36,7,8,51
25/11/15 6:00,0,80,11,15,106
25/11/15 7:00,1,153,16,12,182
25/11/15 8:00,0,256,7,12,275
25/11/15 9:00,0,279,13,19,311
25/11/15 10:00,0,259,19,29,307
25/11/15 11:00,1,241,17,25,284
25/11/15 12:00,0,230,12,37,279
25/11/15 13:00,3,241,15,26,285
25/11/15 14:00,1,275,13,24,313
25/11/15 15:00,1,280,14,24,319
25/11/15 16:00,0,306,11,19,336
25/11/15 17:00,1,285,15,15,316
25/11/15 18:00,2,269,18,18,307
25/11/15 19:00,1,214,13,13,241
25/11/15 20:00,0,172,21,12,205
25/11/15 21:00,0,127,19,16,162
25/11/15 22:00,0,98,17,11,126
25/11/15 23:00,0,43,13,8,64
26/11/15 0:00,0,45,10,7,62
26/11/15 1:00,0,22,5,1,28
26/11/15 2:00,0,26,4,5,35
26/11/15 3:00,0,12,15,11,38
26/11/15 4:00,0,14,5,9,28
26/11/15 5:00,0,35,10,9,54
26/11/15 6:00,0,89,14,19,122
26/11/15 7:00,0,141,24,9,174
26/11/15 8:00,0,262,14,10,286
26/11/15 9:00,0,357,15,16,388
26/11/15 10:00,0,316,13,18,347
26/11/15 11:00,2,270,13,36,321
26/11/15 12:00,0,250,19,22,291
26/11/15 13:00,0,257,16,21,294
26/11/15 14:00,1,292,12,27,332
26/11/15 15:00,0,329,20,29,378
26/11/15 16:00,0,331,15,29,375
26/11/15 17:00,0,344,15,13,372
26/11/15 18:00,0,322,14,17,353
26/11/15 19:00,0,240,11,14,265
26/11/15 20:00,0,191,7,17,215
26/11/15 21:00,0,155,12,12,179
26/11/15 22:00,0,95,14,10,119
26/11/15 23:00,1,81,8,13,103
27/11/15 0:00,0,45,9,2,56
27/11/15 1:00,0,41,8,6,55
27/11/15 2:00,0,25,5,6,36
27/11/15 3:00,0,26,6,8,40
27/11/15 4:00,0,28,6,7,41
27/11/15 5:00,0,30,2,4,36
27/11/15 6:00,0,69,15,13,97
27/11/15 7:00,0,138,11,13,162
27/11/15 8:00,1,263,7,7,278
27/11/15 9:00,0,373,12,12,397
27/11/15 10:00,0,320,22,18,360
27/11/15 11:00,0,290,13,21,324
27/11/15 12:00,0,297,13,27,337
27/11/15 13:00,1,336,14,24,375
27/11/15 14:00,1,400,8,26,435
27/11/15 15:00,1,441,17,32,491
27/11/15 16:00,0,518,13,26,557
27/11/15 17:00,0,505,14,26,545
27/11/15 18:00,0,398,11,26,435
27/11/15 19:00,0,310,9,10,329
27/11/15 20:00,0,232,13,8,253
27/11/15 21:00,0,151,11,19,181
27/11/15 22:00,0,128,12,4,144
27/11/15 23:00,0,78,12,9,99
28/11/15 0:00,0,38,8,2,48
28/11/15 1:00,0,47,6,2,55
28/11/15 2:00,0,24,4,3,31
28/11/15 3:00,0,27,15,9,51
28/11/15 4:00,0,25,6,2,33
28/11/15 5:00,0,36,4,4,44
28/11/15 6:00,0,56,10,2,68
28/11/15 7:00,0,150,18,12,180
28/11/15 8:00,1,212,12,9,234
28/11/15 9:00,0,268,14,7,289
28/11/15 10:00,0,331,25,11,367
28/11/15 11:00,0,343,6,15,364
28/11/15 12:00,0,318,14,8,340
28/11/15 13:00,0,303,7,17,327
28/11/15 14:00,0,293,12,22,327
28/11/15 15:00,0,330,7,9,346
28/11/15 16:00,1,321,12,18,352
28/11/15 17:00,1,334,10,15,360
28/11/15 18:00,0,280,12,6,298
28/11/15 19:00,3,269,9,11,292
28/11/15 20:00,1,182,16,11,210
28/11/15 21:00,0,138,5,4,147
28/11/15 22:00,0,91,7,3,101
28/11/15 23:00,0,74,8,1,83
29/11/15 0:00,0,45,6,2,53
29/11/15 1:00,0,42,5,3,50
29/11/15 2:00,0,19,6,2,27
29/11/15 3:00,0,36,6,3,45
29/11/15 4:00,0,27,7,1,35
29/11/15 5:00,0,27,2,1,30
29/11/15 6:00,0,55,3,1,59
29/11/15 7:00,0,98,4,4,106
29/11/15 8:00,0,164,8,3,175
29/11/15 9:00,0,173,7,3,183
29/11/15 10:00,1,272,18,11,302
29/11/15 11:00,1,296,9,13,319
29/11/15 12:00,1,338,15,24,378
29/11/15 13:00,0,327,18,17,362
29/11/15 14:00,1,385,12,12,410
29/11/15 15:00,1,388,9,10,408
29/11/15 16:00,0,480,11,18,509
29/11/15 17:00,0,482,12,15,509
29/11/15 18:00,0,490,25,18,533
29/11/15 19:00,0,374,26,10,410
29/11/15 20:00,0,330,16,19,365
29/11/15 21:00,0,187,24,16,227
29/11/15 22:00,0,129,10,8,147
29/11/15 23:00,0,96,7,6,109
30/11/15 0:00,0,63,10,9,82
30/11/15 1:00,0,28,4,6,38
30/11/15 2:00,0,21,4,2,27
30/11/15 3:00,0,16,6,11,33
30/11/15 4:00,0,21,7,3,31
30/11/15 5:00,0,41,10,8,59
30/11/15 6:00,0,113,12,14,139
30/11/15 7:00,0,216,15,10,241
30/11/15 8:00,0,251,9,10,270
30/11/15 9:00,0,290,12,16,318
30/11/15 10:00,0,269,21,19,309
30/11/15 11:00,0,272,14,26,312
30/11/15 12:00,2,219,12,19,252
30/11/15 13:00,0,220,10,23,253
30/11/15 14:00,0,245,17,16,278
30/11/15 15:00,0,238,15,22,275
30/11/15 16:00,0,240,17,18,275
30/11/15 17:00,1,275,12,18,306
30/11/15 18:00,0,244,15,20,279
30/11/15 19:00,1,215,15,23,254
30/11/15 20:00,0,141,4,9,154
30/11/15 21:00,1,110,10,16,137
30/11/15 22:00,0,86,16,7,109
30/11/15 23:00,0,54,9,4,67
1/12/15 0:00,0,38,8,5,51
1/12/15 1:00,0,30,8,5,43
1/12/15 2:00,0,15,3,5,23
1/12/15 3:00,0,22,6,5,33
1/12/15 4:00,0,19,9,11,39
1/12/15 5:00,0,29,9,14,52
1/12/15 6:00,0,97,13,12,122
1/12/15 7:00,0,155,7,15,177
1/12/15 8:00,0,216,11,13,240
1/12/15 9:00,0,249,15,19,283
1/12/15 10:00,0,233,18,16,267
1/12/15 11:00,0,242,8,21,271
1/12/15 12:00,1,223,17,34,275
1/12/15 13:00,0,241,17,32,290
1/12/15 14:00,2,218,16,27,263
1/12/15 15:00,1,257,13,21,292
1/12/15 16:00,0,290,11,23,324
1/12/15 17:00,0,215,16,20,251
1/12/15 18:00,0,177,15,23,215
1/12/15 19:00,1,156,22,14,193
1/12/15 20:00,0,116,10,10,136
1/12/15 21:00,0,110,12,10,132
1/12/15 22:00,0,75,14,9,98
1/12/15 23:00,0,64,11,12,87
2/12/15 0:00,0,32,6,7,45
2/12/15 1:00,0,21,7,8,36
2/12/15 2:00,0,30,7,4,41
2/12/15 3:00,0,21,9,1,31
2/12/15 4:00,0,25,9,5,39
2/12/15 5:00,0,44,11,10,65
2/12/15 6:00,0,84,8,17,109
2/12/15 7:00,0,158,19,20,197
2/12/15 8:00,1,194,14,10,219
2/12/15 9:00,0,267,16,12,295
2/12/15 10:00,0,226,14,14,254
2/12/15 11:00,1,192,20,31,244
2/12/15 12:00,0,193,18,26,237
2/12/15 13:00,1,219,14,19,253
2/12/15 14:00,1,226,20,22,269
2/12/15 15:00,0,243,11,23,277
2/12/15 16:00,0,304,21,17,342
2/12/15 17:00,0,251,15,15,281
2/12/15 18:00,0,226,15,18,259
2/12/15 19:00,0,224,14,15,253
2/12/15 20:00,0,165,26,10,201
2/12/15 21:00,0,123,19,21,163
2/12/15 22:00,0,87,9,26,122
2/12/15 23:00,0,59,8,7,74
3/12/15 0:00,0,48,10,6,64
3/12/15 1:00,0,39,4,2,45
3/12/15 2:00,0,28,7,6,41
3/12/15 3:00,0,21,6,7,34
3/12/15 4:00,0,20,7,5,32
3/12/15 5:00,0,41,10,12,63
3/12/15 6:00,2,77,10,13,102
3/12/15 7:00,0,134,19,15,168
3/12/15 8:00,0,225,16,10,251
3/12/15 9:00,0,272,23,14,309
3/12/15 10:00,0,224,18,18,260
3/12/15 11:00,0,227,16,26,269
3/12/15 12:00,1,227,13,25,266
3/12/15 13:00,1,230,21,30,282
3/12/15 14:00,1,244,14,40,299
3/12/15 15:00,3,281,18,25,327
3/12/15 16:00,0,309,21,20,350
3/12/15 17:00,0,245,17,27,289
3/12/15 18:00,0,242,12,17,271
3/12/15 19:00,0,172,14,28,214
3/12/15 20:00,1,146,5,15,167
3/12/15 21:00,0,123,13,7,143
3/12/15 22:00,0,98,8,15,121
3/12/15 23:00,0,49,8,7,64
4/12/15 0:00,0,26,7,1,34
4/12/15 1:00,0,33,5,8,46
4/12/15 2:00,0,21,3,7,31
4/12/15 3:00,0,23,6,3,32
4/12/15 4:00,0,27,7,10,44
4/12/15 5:00,0,31,11,3,45
4/12/15 6:00,0,87,12,19,118
4/12/15 7:00,0,160,12,18,190
4/12/15 8:00,0,188,9,10,207
4/12/15 9:00,0,255,18,16,289
4/12/15 10:00,1,251,13,14,279
4/12/15 11:00,0,262,14,23,299
4/12/15 12:00,0,273,15,26,314
4/12/15 13:00,3,359,18,44,424
4/12/15 14:00,0,373,17,26,416
4/12/15 15:00,0,415,15,23,453
4/12/15 16:00,1,539,19,14,573
4/12/15 17:00,0,406,19,26,451
4/12/15 18:00,0,383,14,12,409
4/12/15 19:00,1,322,16,9,348
4/12/15 20:00,2,222,9,13,246
4/12/15 21:00,1,186,20,5,212
4/12/15 22:00,1,103,11,4,119
4/12/15 23:00,1,60,6,7,74
5/12/15 0:00,0,58,9,2,69
5/12/15 1:00,1,31,8,7,47
5/12/15 2:00,0,23,7,3,33
5/12/15 3:00,0,32,7,10,49
5/12/15 4:00,0,26,5,1,32
5/12/15 5:00,0,27,3,7,37
5/12/15 6:00,0,60,7,8,75
5/12/15 7:00,0,115,16,12,143
5/12/15 8:00,1,177,11,7,196
5/12/15 9:00,0,261,13,10,284
5/12/15 10:00,1,295,14,9,319
5/12/15 11:00,1,295,15,13,324
5/12/15 12:00,2,297,10,18,327
5/12/15 13:00,0,277,8,19,304
5/12/15 14:00,0,266,12,22,300
5/12/15 15:00,0,281,11,11,303
5/12/15 16:00,0,274,13,8,295
5/12/15 17:00,1,318,9,20,348
5/12/15 18:00,1,289,18,8,316
5/12/15 19:00,1,270,19,9,299
5/12/15 20:00,0,156,17,8,181
5/12/15 21:00,0,150,9,5,164
5/12/15 22:00,0,100,10,2,112
5/12/15 23:00,0,59,9,6,74
6/12/15 0:00,0,75,6,5,86
6/12/15 1:00,0,32,8,3,43
6/12/15 2:00,0,22,3,1,26
6/12/15 3:00,0,23,4,1,28
6/12/15 4:00,0,26,4,6,36
6/12/15 5:00,0,28,5,5,38
6/12/15 6:00,0,50,7,11,68
6/12/15 7:00,0,93,2,3,98
6/12/15 8:00,0,99,4,5,108
6/12/15 9:00,1,165,7,9,182
6/12/15 10:00,1,251,18,15,285
6/12/15 11:00,1,250,11,17,279
6/12/15 12:00,1,320,15,24,360
6/12/15 13:00,4,365,10,20,399
6/12/15 14:00,0,324,15,18,357
6/12/15 15:00,2,363,16,22,403
6/12/15 16:00,3,464,17,22,506
6/12/15 17:00,4,493,11,18,526
6/12/15 18:00,1,463,11,15,490
6/12/15 19:00,0,392,18,9,419
6/12/15 20:00,1,284,19,10,314
6/12/15 21:00,1,223,11,17,252
6/12/15 22:00,0,122,17,6,145
6/12/15 23:00,0,79,10,8,97
7/12/15 0:00,0,58,4,10,72
7/12/15 1:00,0,28,5,9,42
7/12/15 2:00,0,20,2,4,26
7/12/15 3:00,0,19,4,5,28
7/12/15 4:00,0,27,9,5,41
7/12/15 5:00,0,44,7,2,53
7/12/15 6:00,0,123,8,8,139
7/12/15 7:00,0,217,14,9,240
7/12/15 8:00,1,278,11,18,308
7/12/15 9:00,0,280,16,12,308
7/12/15 10:00,1,260,15,23,299
7/12/15 11:00,0,242,15,24,281
7/12/15 12:00,1,213,12,26,252
7/12/15 13:00,1,225,14,25,265
7/12/15 14:00,3,256,12,32,303
7/12/15 15:00,0,273,8,22,303
7/12/15 16:00,0,283,13,16,312
7/12/15 17:00,0,253,14,19,286
7/12/15 18:00,0,200,13,17,230
7/12/15 19:00,0,180,13,15,208
7/12/15 20:00,0,151,6,16,173
7/12/15 21:00,0,102,13,15,130
7/12/15 22:00,0,88,5,5,98
7/12/15 23:00,0,51,11,12,74
8/12/15 0:00,0,48,13,3,64
8/12/15 1:00,0,39,4,4,47
8/12/15 2:00,0,20,4,2,26
8/12/15 3:00,0,16,7,3,26
8/12/15 4:00,0,15,7,3,25
8/12/15 5:00,0,32,8,5,45
8/12/15 6:00,0,81,18,10,109
8/12/15 7:00,0,177,15,13,205
8/12/15 8:00,0,233,22,12,267
8/12/15 9:00,0,288,11,13,312
8/12/15 10:00,0,267,12,18,297
8/12/15 11:00,0,212,16,30,258
8/12/15 12:00,0,225,13,35,273
8/12/15 13:00,0,252,23,32,307
8/12/15 14:00,0,263,13,28,304
8/12/15 15:00,0,246,16,29,291
8/12/15 16:00,1,227,17,27,272
8/12/15 17:00,0,245,15,18,278
8/12/15 18:00,1,209,11,27,248
8/12/15 19:00,0,196,10,24,230
8/12/15 20:00,0,126,7,19,152
8/12/15 21:00,0,78,10,13,101
8/12/15 22:00,0,76,12,11,99
8/12/15 23:00,0,54,6,8,68
9/12/15 0:00,0,48,8,11,67
9/12/15 1:00,0,26,3,6,35
9/12/15 2:00,0,25,9,4,38
9/12/15 3:00,0,16,10,3,29
9/12/15 4:00,0,19,9,3,31
9/12/15 5:00,0,42,8,10,60
9/12/15 6:00,0,74,9,8,91
9/12/15 7:00,0,143,12,13,168
9/12/15 8:00,0,209,13,11,233
9/12/15 9:00,0,256,13,11,280
9/12/15 10:00,0,250,16,15,281
9/12/15 11:00,0,207,18,30,255
9/12/15 12:00,1,196,15,36,248
9/12/15 13:00,1,235,17,31,284
9/12/15 14:00,1,252,12,13,278
9/12/15 15:00,0,285,16,17,318
9/12/15 16:00,1,281,21,18,321
9/12/15 17:00,1,258,16,21,296
9/12/15 18:00,1,200,15,17,233
9/12/15 19:00,0,170,9,19,198
9/12/15 20:00,0,155,24,18,197
9/12/15 21:00,0,103,18,19,140
9/12/15 22:00,0,87,10,7,104
9/12/15 23:00,0,44,6,11,61
10/12/15 0:00,0,35,5,12,52
10/12/15 1:00,0,37,9,5,51
10/12/15 2:00,0,24,6,7,37
10/12/15 3:00,0,17,5,7,29
10/12/15 4:00,0,20,4,6,30
10/12/15 5:00,0,42,15,10,67
10/12/15 6:00,0,84,14,19,117
10/12/15 7:00,0,138,25,12,175
10/12/15 8:00,0,259,15,8,282
10/12/15 9:00,0,289,16,11,316
10/12/15 10:00,0,235,16,23,274
10/12/15 11:00,0,279,18,30,327
10/12/15 12:00,1,237,14,33,285
10/12/15 13:00,0,248,23,25,296
10/12/15 14:00,0,280,17,28,325
10/12/15 15:00,0,286,19,23,328
10/12/15 16:00,0,312,17,37,366
10/12/15 17:00,0,254,19,26,299
10/12/15 18:00,0,247,16,21,284
10/12/15 19:00,0,171,9,20,200
10/12/15 20:00,0,144,11,24,179
10/12/15 21:00,2,126,10,9,147
10/12/15 22:00,0,87,14,13,114
10/12/15 23:00,0,62,7,9,78
11/12/15 0:00,0,41,9,7,57
11/12/15 1:00,0,25,4,9,38
11/12/15 2:00,0,15,6,10,31
11/12/15 3:00,0,24,5,2,31
11/12/15 4:00,0,24,8,6,38
11/12/15 5:00,0,35,8,16,59
11/12/15 6:00,0,72,15,15,102
11/12/15 7:00,0,117,18,19,154
11/12/15 8:00,0,208,13,15,236
11/12/15 9:00,0,257,11,16,284
11/12/15 10:00,0,274,22,19,315
11/12/15 11:00,0,282,13,25,320
11/12/15 12:00,1,281,14,27,323
11/12/15 13:00,0,286,15,33,334
11/12/15 14:00,0,329,16,36,381
11/12/15 15:00,0,383,20,16,419
11/12/15 16:00,1,454,18,25,498
11/12/15 17:00,0,378,15,18,411
11/12/15 18:00,0,387,22,10,419
11/12/15 19:00,0,280,20,14,314
11/12/15 20:00,0,193,10,19,222
11/12/15 21:00,0,143,19,6,168
11/12/15 22:00,0,120,5,5,130
11/12/15 23:00,0,83,7,5,95
12/12/15 0:00,0,46,7,6,59
12/12/15 1:00,0,35,5,5,45
12/12/15 2:00,0,25,7,3,35
12/12/15 3:00,0,28,9,4,41
12/12/15 4:00,0,28,6,6,40
12/12/15 5:00,0,39,5,7,51
12/12/15 6:00,0,72,6,2,80
12/12/15 7:00,1,156,11,9,177
12/12/15 8:00,1,182,11,10,204
12/12/15 9:00,0,266,16,12,294
12/12/15 10:00,0,285,14,10,309
12/12/15 11:00,0,320,14,17,351
12/12/15 12:00,0,308,14,11,333
12/12/15 13:00,1,314,11,15,341
12/12/15 14:00,1,276,10,27,314
12/12/15 15:00,0,294,13,22,329
12/12/15 16:00,1,310,13,11,335
12/12/15 17:00,1,258,12,16,287
12/12/15 18:00,0,289,9,9,307
12/12/15 19:00,0,287,9,8,304
12/12/15 20:00,1,191,15,11,218
12/12/15 21:00,0,138,8,3,149
12/12/15 22:00,0,109,6,4,119
12/12/15 23:00,0,71,8,3,82
13/12/15 0:00,0,35,8,3,46
13/12/15 1:00,0,30,5,0,35
13/12/15 2:00,0,22,3,0,25
13/12/15 3:00,0,26,8,4,38
13/12/15 4:00,0,18,4,1,23
13/12/15 5:00,0,27,5,4,36
13/12/15 6:00,0,53,2,1,56
13/12/15 7:00,0,87,4,4,95
13/12/15 8:00,0,130,7,6,143
13/12/15 9:00,0,202,12,9,223
13/12/15 10:00,1,215,11,10,237
13/12/15 11:00,1,290,21,6,318
13/12/15 12:00,0,270,8,12,290
13/12/15 13:00,0,261,14,26,301
13/12/15 14:00,1,297,6,11,315
13/12/15 15:00,2,331,14,9,356
13/12/15 16:00,2,384,12,9,407
13/12/15 17:00,1,461,13,20,495
13/12/15 18:00,0,442,16,21,479
13/12/15 19:00,0,381,15,19,415
13/12/15 20:00,0,330,16,13,359
13/12/15 21:00,0,206,13,13,232
13/12/15 22:00,0,154,14,8,176
13/12/15 23:00,0,97,13,11,121
14/12/15 0:00,0,56,10,11,77
14/12/15 1:00,0,35,5,4,44
14/12/15 2:00,0,20,6,5,31
14/12/15 3:00,0,19,7,3,29
14/12/15 4:00,0,26,4,10,40
14/12/15 5:00,0,39,7,8,54
14/12/15 6:00,0,109,8,10,127
14/12/15 7:00,0,199,8,10,217
14/12/15 8:00,0,254,3,13,270
14/12/15 9:00,1,261,20,13,295
14/12/15 10:00,0,250,21,16,287
14/12/15 11:00,0,188,12,15,215
14/12/15 12:00,0,52,4,1,57
14/12/15 13:00,1,221,13,28,263
14/12/15 14:00,1,251,8,18,278
14/12/15 15:00,0,241,14,25,280
14/12/15 16:00,0,263,14,19,296
14/12/15 17:00,1,281,13,26,321
14/12/15 18:00,0,219,13,20,252
14/12/15 19:00,0,181,17,26,224
14/12/15 20:00,0,126,7,13,146
14/12/15 21:00,0,94,11,11,116
14/12/15 22:00,0,71,14,8,93
14/12/15 23:00,0,66,6,7,79
15/12/15 0:00,0,37,6,5,48
15/12/15 1:00,0,30,8,5,43
15/12/15 2:00,0,18,6,1,25
15/12/15 3:00,0,27,4,4,35
15/12/15 4:00,0,10,8,7,25
15/12/15 5:00,0,40,12,15,67
15/12/15 6:00,0,77,13,15,105
15/12/15 7:00,0,158,16,7,181
15/12/15 8:00,0,215,15,12,242
15/12/15 9:00,0,235,16,15,266
15/12/15 10:00,1,227,14,25,267
15/12/15 11:00,1,212,14,30,257
15/12/15 12:00,0,207,20,37,264
15/12/15 13:00,0,266,17,29,312
15/12/15 14:00,0,267,14,32,313
15/12/15 15:00,0,235,16,27,278
15/12/15 16:00,0,249,18,24,291
15/12/15 17:00,0,238,14,19,271
15/12/15 18:00,0,255,17,20,292
15/12/15 19:00,0,167,12,22,201
15/12/15 20:00,0,122,10,9,141
15/12/15 21:00,1,115,11,20,147
15/12/15 22:00,0,85,14,16,115
15/12/15 23:00,1,59,7,10,77
16/12/15 0:00,0,38,8,9,55
16/12/15 1:00,0,27,3,8,38
16/12/15 2:00,0,24,6,0,30
16/12/15 3:00,0,24,8,5,37
16/12/15 4:00,0,19,8,8,35
16/12/15 5:00,0,47,7,7,61
16/12/15 6:00,0,90,14,15,119
16/12/15 7:00,0,190,16,19,225
16/12/15 8:00,0,194,19,14,227
16/12/15 9:00,0,249,18,18,285
16/12/15 10:00,2,286,15,18,321
16/12/15 11:00,0,247,17,32,296
16/12/15 12:00,2,276,20,30,328
16/12/15 13:00,0,287,22,30,339
16/12/15 14:00,0,309,14,44,367
16/12/15 15:00,0,302,20,32,354
16/12/15 16:00,2,304,26,15,347
16/12/15 17:00,0,259,20,17,296
16/12/15 18:00,0,254,14,15,283
16/12/15 19:00,1,221,19,19,260
16/12/15 20:00,0,192,25,14,231
16/12/15 21:00,0,120,15,19,154
16/12/15 22:00,0,91,13,9,113
16/12/15 23:00,0,37,4,9,50
17/12/15 0:00,0,49,7,4,60
17/12/15 1:00,0,33,6,2,41
17/12/15 2:00,0,18,7,15,40
17/12/15 3:00,0,16,6,7,29
17/12/15 4:00,0,19,8,11,38
17/12/15 5:00,0,30,8,9,47
17/12/15 6:00,0,70,17,12,99
17/12/15 7:00,0,176,20,15,211
17/12/15 8:00,0,231,13,14,258
17/12/15 9:00,0,279,11,15,305
17/12/15 10:00,0,266,17,17,300
17/12/15 11:00,0,290,14,20,324
17/12/15 12:00,0,241,21,30,292
17/12/15 13:00,2,305,20,26,353
17/12/15 14:00,0,261,14,47,322
17/12/15 15:00,0,308,19,27,354
17/12/15 16:00,0,317,18,19,354
17/12/15 17:00,0,263,20,24,307
17/12/15 18:00,1,229,15,18,263
17/12/15 19:00,0,194,13,14,221
17/12/15 20:00,0,148,12,13,173
17/12/15 21:00,0,146,9,21,176
17/12/15 22:00,0,90,12,15,117
17/12/15 23:00,0,56,3,7,66
18/12/15 0:00,0,46,7,10,63
18/12/15 1:00,0,41,11,6,58
18/12/15 2:00,0,25,6,9,40
18/12/15 3:00,0,20,4,2,26
18/12/15 4:00,0,22,7,14,43
18/12/15 5:00,0,36,8,10,54
18/12/15 6:00,0,58,14,17,89
18/12/15 7:00,0,151,9,10,170
18/12/15 8:00,0,216,13,11,240
18/12/15 9:00,1,248,20,12,281
18/12/15 10:00,1,253,16,33,303
18/12/15 11:00,0,283,18,30,331
18/12/15 12:00,0,310,20,25,355
18/12/15 13:00,0,305,26,33,364
18/12/15 14:00,1,349,15,36,401
18/12/15 15:00,0,374,19,23,416
18/12/15 16:00,1,418,20,22,461
18/12/15 17:00,0,399,19,31,449
18/12/15 18:00,0,336,19,17,372
18/12/15 19:00,0,276,23,19,318
18/12/15 20:00,0,232,23,16,271
18/12/15 21:00,0,180,20,11,211
18/12/15 22:00,0,145,7,9,161
18/12/15 23:00,0,80,8,12,100
19/12/15 0:00,0,57,8,8,73
19/12/15 1:00,0,42,6,9,57
19/12/15 2:00,0,31,9,1,41
19/12/15 3:00,0,26,6,4,36
19/12/15 4:00,0,32,4,7,43
19/12/15 5:00,0,42,9,6,57
19/12/15 6:00,0,67,10,12,89
19/12/15 7:00,0,182,7,10,199
19/12/15 8:00,0,204,15,13,232
19/12/15 9:00,0,292,19,18,329
19/12/15 10:00,0,338,15,11,364
19/12/15 11:00,0,327,13,32,372
19/12/15 12:00,1,316,9,24,350
19/12/15 13:00,1,309,17,21,348
19/12/15 14:00,0,289,13,17,319
19/12/15 15:00,1,316,9,16,342
19/12/15 16:00,0,311,9,19,339
19/12/15 17:00,2,329,11,14,356
19/12/15 18:00,0,279,13,11,303
19/12/15 19:00,2,314,16,14,346
19/12/15 20:00,0,185,9,6,200
19/12/15 21:00,0,149,6,6,161
19/12/15 22:00,0,120,7,3,130
19/12/15 23:00,0,81,9,3,93
20/12/15 0:00,0,44,5,2,51
20/12/15 1:00,0,33,5,5,43
20/12/15 2:00,0,41,6,3,50
20/12/15 3:00,0,27,5,5,37
20/12/15 4:00,0,35,5,2,42
20/12/15 5:00,0,43,6,4,53
20/12/15 6:00,0,62,4,7,73
20/12/15 7:00,0,91,0,4,95
20/12/15 8:00,0,153,10,6,169
20/12/15 9:00,0,219,9,8,236
20/12/15 10:00,1,250,8,18,277
20/12/15 11:00,1,303,9,10,323
20/12/15 12:00,1,304,17,18,340
20/12/15 13:00,1,319,10,20,350
20/12/15 14:00,0,331,16,10,357
20/12/15 15:00,1,353,5,12,371
20/12/15 16:00,1,387,16,20,424
20/12/15 17:00,0,400,13,12,425
20/12/15 18:00,0,384,17,19,420
20/12/15 19:00,0,340,11,22,373
20/12/15 20:00,0,289,17,12,318
20/12/15 21:00,0,197,10,21,228
20/12/15 22:00,0,123,13,10,146
20/12/15 23:00,0,120,10,8,138
21/12/15 0:00,0,61,12,10,83
21/12/15 1:00,0,41,6,6,53
21/12/15 2:00,0,26,5,6,37
21/12/15 3:00,0,20,3,5,28
21/12/15 4:00,0,34,5,2,41
21/12/15 5:00,0,48,5,10,63
21/12/15 6:00,0,134,15,7,156
21/12/15 7:00,0,173,9,17,199
21/12/15 8:00,0,216,4,16,236
21/12/15 9:00,0,203,11,17,231
21/12/15 10:00,0,287,16,29,332
21/12/15 11:00,0,245,14,21,280
21/12/15 12:00,1,247,11,23,282
21/12/15 13:00,0,263,16,21,300
21/12/15 14:00,0,277,16,20,313
21/12/15 15:00,1,297,11,26,335
21/12/15 16:00,0,294,18,12,324
21/12/15 17:00,0,271,20,14,305
21/12/15 18:00,0,230,14,14,258
21/12/15 19:00,0,172,15,12,199
21/12/15 20:00,0,144,8,20,172
21/12/15 21:00,0,136,10,17,163
21/12/15 22:00,0,108,7,6,121
21/12/15 23:00,0,65,5,6,76
22/12/15 0:00,0,55,7,5,67
22/12/15 1:00,0,40,5,7,52
22/12/15 2:00,0,16,6,5,27
22/12/15 3:00,0,20,3,6,29
22/12/15 4:00,0,22,7,10,39
22/12/15 5:00,0,26,15,8,49
22/12/15 6:00,0,65,19,15,99
22/12/15 7:00,0,144,8,15,167
22/12/15 8:00,0,210,10,5,225
22/12/15 9:00,0,238,16,8,262
22/12/15 10:00,1,275,15,25,316
22/12/15 11:00,0,257,15,19,291
22/12/15 12:00,1,277,20,20,318
22/12/15 13:00,2,312,15,21,350
22/12/15 14:00,0,305,15,21,341
22/12/15 15:00,3,288,16,32,339
22/12/15 16:00,3,338,18,25,384
22/12/15 17:00,1,311,14,24,350
22/12/15 18:00,0,254,20,26,300
22/12/15 19:00,1,202,16,18,237
22/12/15 20:00,0,181,11,9,201
22/12/15 21:00,0,150,12,12,174
22/12/15 22:00,0,116,8,9,133
22/12/15 23:00,0,88,6,16,110
23/12/15 0:00,0,48,10,9,67
23/12/15 1:00,0,54,7,8,69
23/12/15 2:00,0,25,9,5,39
23/12/15 3:00,0,34,8,5,47
23/12/15 4:00,0,25,9,5,39
23/12/15 5:00,0,37,7,10,54
23/12/15 6:00,0,63,13,27,103
23/12/15 7:00,0,142,12,7,161
23/12/15 8:00,0,209,8,13,230
23/12/15 9:00,0,263,14,5,282
23/12/15 10:00,0,325,16,23,364
23/12/15 11:00,0,358,18,29,405
23/12/15 12:00,0,422,12,32,466
23/12/15 13:00,0,495,18,26,539
23/12/15 14:00,4,442,15,39,500
23/12/15 15:00,2,500,21,17,540
23/12/15 16:00,1,588,18,29,636
23/12/15 17:00,1,541,16,23,581
23/12/15 18:00,0,439,15,18,472
23/12/15 19:00,1,448,13,14,476
23/12/15 20:00,0,321,19,17,357
23/12/15 21:00,0,235,17,22,274
23/12/15 22:00,0,162,14,15,191
23/12/15 23:00,0,112,6,10,128
24/12/15 0:00,0,58,12,9,79
24/12/15 1:00,0,58,7,1,66
24/12/15 2:00,0,26,5,2,33
24/12/15 3:00,0,40,5,3,48
24/12/15 4:00,0,27,7,1,35
24/12/15 5:00,0,45,10,7,62
24/12/15 6:00,0,62,3,9,74
24/12/15 7:00,0,131,15,3,149
24/12/15 8:00,0,160,11,8,179
24/12/15 9:00,0,307,15,18,340
24/12/15 10:00,0,355,14,14,383
24/12/15 11:00,0,470,12,15,497
24/12/15 12:00,1,586,17,21,625
24/12/15 13:00,0,552,13,28,593
24/12/15 14:00,2,544,14,26,586
24/12/15 15:00,0,547,9,13,569
24/12/15 16:00,1,618,17,12,648
24/12/15 17:00,0,605,15,7,627
24/12/15 18:00,0,520,12,4,536
24/12/15 19:00,0,453,8,7,468
24/12/15 20:00,0,295,7,7,309
24/12/15 21:00,0,186,8,6,200
24/12/15 22:00,0,124,5,1,130
24/12/15 23:00,0,81,6,2,89
25/12/15 0:00,0,55,6,4,65
25/12/15 1:00,0,41,4,2,47
25/12/15 2:00,0,18,3,0,21
25/12/15 3:00,0,22,7,2,31
25/12/15 4:00,0,16,0,1,17
25/12/15 5:00,1,29,2,1,33
25/12/15 6:00,0,35,1,1,37
25/12/15 7:00,0,43,0,1,44
25/12/15 8:00,0,76,2,1,79
25/12/15 9:00,0,125,0,2,127
25/12/15 10:00,0,256,1,0,257
25/12/15 11:00,0,388,3,2,393
25/12/15 12:00,2,375,3,5,385
25/12/15 13:00,2,262,2,15,281
25/12/15 14:00,0,156,1,15,172
25/12/15 15:00,1,134,1,4,140
25/12/15 16:00,0,186,4,7,197
25/12/15 17:00,0,214,2,9,225
25/12/15 18:00,0,212,5,8,225
25/12/15 19:00,0,154,1,16,171
25/12/15 20:00,0,111,0,4,115
25/12/15 21:00,0,99,5,6,110
25/12/15 22:00,0,58,3,1,62
25/12/15 23:00,0,50,3,2,55
26/12/15 0:00,0,40,4,1,45
26/12/15 1:00,0,29,3,2,34
26/12/15 2:00,0,19,2,4,25
26/12/15 3:00,0,23,3,3,29
26/12/15 4:00,0,32,1,1,34
26/12/15 5:00,0,40,3,1,44
26/12/15 6:00,0,48,3,4,55
26/12/15 7:00,0,67,1,0,68
26/12/15 8:00,0,99,3,7,109
26/12/15 9:00,1,203,2,10,216
26/12/15 10:00,0,311,5,4,320
26/12/15 11:00,1,496,4,8,509
26/12/15 12:00,5,522,7,19,553
26/12/15 13:00,0,382,5,12,399
26/12/15 14:00,1,341,6,8,356
26/12/15 15:00,2,340,3,11,356
26/12/15 16:00,2,389,10,22,423
26/12/15 17:00,0,409,7,9,425
26/12/15 18:00,0,370,9,10,389
26/12/15 19:00,1,351,5,6,363
26/12/15 20:00,0,223,15,2,240
26/12/15 21:00,0,155,9,8,172
26/12/15 22:00,0,99,5,8,112
26/12/15 23:00,0,81,8,4,93
27/12/15 0:00,0,65,8,6,79
27/12/15 1:00,0,32,4,1,37
27/12/15 2:00,0,27,7,2,36
27/12/15 3:00,0,30,7,2,39
27/12/15 4:00,0,31,6,3,40
27/12/15 5:00,0,39,5,0,44
27/12/15 6:00,0,71,8,10,89
27/12/15 7:00,1,118,3,1,123
27/12/15 8:00,0,158,10,4,172
27/12/15 9:00,0,283,13,5,301
27/12/15 10:00,0,464,14,9,487
27/12/15 11:00,1,576,14,3,594
27/12/15 12:00,0,583,8,9,600
27/12/15 13:00,2,555,13,16,586
27/12/15 14:00,0,566,11,12,589
27/12/15 15:00,1,624,9,10,644
27/12/15 16:00,2,745,11,4,762
27/12/15 17:00,0,701,9,9,719
27/12/15 18:00,0,689,11,6,706
27/12/15 19:00,1,550,15,11,577
27/12/15 20:00,2,427,9,8,446
27/12/15 21:00,0,269,18,5,292
27/12/15 22:00,1,181,9,7,198
27/12/15 23:00,0,99,9,1,109
28/12/15 0:00,0,53,10,4,67
28/12/15 1:00,0,43,6,2,51
28/12/15 2:00,0,28,2,5,35
28/12/15 3:00,0,24,5,4,33
28/12/15 4:00,0,30,8,4,42
28/12/15 5:00,0,48,6,5,59
28/12/15 6:00,0,103,9,7,119
28/12/15 7:00,0,167,11,10,188
28/12/15 8:00,0,195,6,9,210
28/12/15 9:00,1,276,20,11,308
28/12/15 10:00,0,379,8,16,403
28/12/15 11:00,1,445,16,22,484
28/12/15 12:00,0,430,22,3,455
28/12/15 13:00,0,456,14,23,493
28/12/15 14:00,1,435,8,18,462
28/12/15 15:00,0,423,20,15,458
28/12/15 16:00,1,494,16,8,519
28/12/15 17:00,0,470,15,16,501
28/12/15 18:00,0,417,16,16,449
28/12/15 19:00,0,309,14,13,336
28/12/15 20:00,0,242,8,5,255
28/12/15 21:00,0,199,10,10,219
28/12/15 22:00,0,118,13,6,137
28/12/15 23:00,0,78,7,8,93
29/12/15 0:00,0,63,6,5,74
29/12/15 1:00,0,47,6,4,57
29/12/15 2:00,0,18,5,3,26
29/12/15 3:00,0,26,1,4,31
29/12/15 4:00,0,33,7,5,45
29/12/15 5:00,0,38,9,11,58
29/12/15 6:00,0,67,13,11,91
29/12/15 7:00,0,121,7,6,134
29/12/15 8:00,0,200,11,14,225
29/12/15 9:00,0,283,14,9,306
29/12/15 10:00,1,367,18,13,399
29/12/15 11:00,2,393,11,11,417
29/12/15 12:00,2,425,14,20,461
29/12/15 13:00,1,462,19,15,497
29/12/15 14:00,0,500,18,13,531
29/12/15 15:00,0,494,14,12,520
29/12/15 16:00,1,514,22,15,552
29/12/15 17:00,0,440,21,28,489
29/12/15 18:00,0,370,16,13,399
29/12/15 19:00,0,266,21,12,299
29/12/15 20:00,0,215,13,6,234
29/12/15 21:00,0,165,8,14,187
29/12/15 22:00,0,102,13,9,124
29/12/15 23:00,0,62,7,8,77
30/12/15 0:00,0,47,6,4,57
30/12/15 1:00,0,38,8,1,47
30/12/15 2:00,0,20,5,2,27
30/12/15 3:00,0,23,5,4,32
30/12/15 4:00,0,23,6,4,33
30/12/15 5:00,0,37,5,7,49
30/12/15 6:00,0,63,14,9,86
30/12/15 7:00,0,101,10,13,124
30/12/15 8:00,0,187,7,10,204
30/12/15 9:00,0,312,14,10,336
30/12/15 10:00,0,370,21,13,404
30/12/15 11:00,0,496,13,21,530
30/12/15 12:00,1,464,12,14,491
30/12/15 13:00,0,472,23,21,516
30/12/15 14:00,0,494,16,23,533
30/12/15 15:00,2,428,16,17,463
30/12/15 16:00,0,443,18,29,490
30/12/15 17:00,3,359,14,24,400
30/12/15 18:00,0,355,17,15,387
30/12/15 19:00,2,365,13,13,393
30/12/15 20:00,0,276,19,12,307
30/12/15 21:00,0,158,13,15,186
30/12/15 22:00,0,110,13,9,132
30/12/15 23:00,0,65,5,2,72
31/12/15 0:00,0,49,13,6,68
31/12/15 1:00,0,28,4,6,38
31/12/15 2:00,0,27,11,6,44
31/12/15 3:00,0,15,4,2,21
31/12/15 4:00,0,20,6,3,29
31/12/15 5:00,0,26,2,7,35
31/12/15 6:00,0,43,12,10,65
31/12/15 7:00,0,54,11,6,71
31/12/15 8:00,0,89,6,3,98
31/12/15 9:00,0,150,14,11,175
31/12/15 10:00,0,202,8,7,217
31/12/15 11:00,0,302,10,9,321
31/12/15 12:00,0,364,3,5,372
31/12/15 13:00,0,329,7,14,350
31/12/15 14:00,1,365,13,15,394
31/12/15 15:00,0,371,6,14,391
31/12/15 16:00,0,410,9,3,422
31/12/15 17:00,0,370,8,7,385
31/12/15 18:00,0,294,6,1,301
31/12/15 19:00,0,217,6,5,228
31/12/15 20:00,0,196,3,1,200
31/12/15 21:00,0,101,4,1,106
31/12/15 22:00,0,68,3,0,71
31/12/15 23:00,0,45,0,3,48
1/1/16 0:00,0,26,1,3,30
1/1/16 1:00,0,28,5,1,34
1/1/16 2:00,0,13,3,2,18
1/1/16 3:00,0,12,3,0,15
1/1/16 4:00,0,6,0,1,7
1/1/16 5:00,0,14,2,0,16
1/1/16 6:00,0,20,1,2,23
1/1/16 7:00,0,35,1,1,37
1/1/16 8:00,0,42,1,1,44
1/1/16 9:00,0,86,1,1,88
1/1/16 10:00,0,128,0,2,130
1/1/16 11:00,0,236,2,6,244
1/1/16 12:00,0,283,1,12,296
1/1/16 13:00,0,267,3,3,273
1/1/16 14:00,0,196,4,10,210
1/1/16 15:00,0,199,1,6,206
1/1/16 16:00,0,207,6,8,221
1/1/16 17:00,0,237,1,7,245
1/1/16 18:00,0,193,3,2,198
1/1/16 19:00,0,169,2,2,173
1/1/16 20:00,0,114,3,1,118
1/1/16 21:00,1,84,2,0,87
1/1/16 22:00,0,56,6,1,63
1/1/16 23:00,0,38,2,0,40
2/1/16 0:00,1,30,2,1,34
2/1/16 1:00,0,27,2,0,29
2/1/16 2:00,0,8,5,0,13
2/1/16 3:00,0,31,2,1,34
2/1/16 4:00,0,19,1,0,20
2/1/16 5:00,0,21,2,1,24
2/1/16 6:00,0,53,2,0,55
2/1/16 7:00,0,61,2,1,64
2/1/16 8:00,0,102,3,0,105
2/1/16 9:00,0,195,5,5,205
2/1/16 10:00,0,301,8,1,310
2/1/16 11:00,0,469,9,5,483
2/1/16 12:00,0,543,8,10,561
2/1/16 13:00,1,487,6,2,496
2/1/16 14:00,0,409,5,5,419
2/1/16 15:00,0,408,5,9,422
2/1/16 16:00,0,406,9,9,424
2/1/16 17:00,0,368,6,0,374
2/1/16 18:00,0,349,7,3,359
2/1/16 19:00,0,274,12,4,290
2/1/16 20:00,1,164,7,2,174
2/1/16 21:00,0,134,5,2,141
2/1/16 22:00,0,87,7,5,99
2/1/16 23:00,0,51,4,0,55
3/1/16 0:00,0,51,7,1,59
3/1/16 1:00,0,31,3,2,36
3/1/16 2:00,0,24,3,1,28
3/1/16 3:00,0,24,6,1,31
3/1/16 4:00,0,20,4,0,24
3/1/16 5:00,0,34,5,0,39
3/1/16 6:00,0,44,4,0,48
3/1/16 7:00,0,58,6,3,67
3/1/16 8:00,0,99,17,2,118
3/1/16 9:00,0,194,13,6,213
3/1/16 10:00,0,350,14,5,369
3/1/16 11:00,0,565,10,4,579
3/1/16 12:00,0,588,11,14,613
3/1/16 13:00,0,618,21,11,650
3/1/16 14:00,0,713,15,14,742
3/1/16 15:00,0,590,15,14,619
3/1/16 16:00,0,594,21,15,630
3/1/16 17:00,0,555,21,8,584
3/1/16 18:00,1,402,20,8,431
3/1/16 19:00,0,269,16,4,289
3/1/16 20:00,0,161,15,2,178
3/1/16 21:00,0,128,12,6,146
3/1/16 22:00,0,69,17,7,93
3/1/16 23:00,0,55,11,9,75
4/1/16 0:00,0,54,10,3,67
4/1/16 1:00,0,29,12,1,42
4/1/16 2:00,0,21,5,2,28
4/1/16 3:00,0,15,9,3,27
4/1/16 4:00,0,14,6,0,20
4/1/16 5:00,0,23,6,0,29
4/1/16 6:00,0,58,9,4,71
4/1/16 7:00,0,99,8,5,112
4/1/16 8:00,0,129,2,9,140
4/1/16 9:00,0,156,7,9,172
4/1/16 10:00,0,218,14,22,254
4/1/16 11:00,0,297,12,12,321
4/1/16 12:00,0,335,13,14,362
4/1/16 13:00,0,347,8,9,364
4/1/16 14:00,0,367,16,11,394
4/1/16 15:00,0,365,13,14,392
4/1/16 16:00,0,313,12,7,332
4/1/16 17:00,0,292,12,18,322
4/1/16 18:00,0,208,10,11,229
4/1/16 19:00,0,154,12,8,174
4/1/16 20:00,0,112,6,10,128
4/1/16 21:00,0,90,10,6,106
4/1/16 22:00,0,71,7,9,87
4/1/16 23:00,0,40,8,8,56
5/1/16 0:00,0,43,6,4,53
5/1/16 1:00,0,29,5,2,36
5/1/16 2:00,0,19,5,0,24
5/1/16 3:00,0,11,6,1,18
5/1/16 4:00,0,17,8,3,28
5/1/16 5:00,1,22,8,3,34
5/1/16 6:00,0,37,12,8,57
5/1/16 7:00,0,96,10,13,119
5/1/16 8:00,0,140,10,6,156
5/1/16 9:00,0,192,11,15,218
5/1/16 10:00,0,234,12,12,258
5/1/16 11:00,0,314,18,18,350
5/1/16 12:00,0,289,16,16,321
5/1/16 13:00,0,308,12,10,330
5/1/16 14:00,0,353,11,14,378
5/1/16 15:00,0,356,14,13,383
5/1/16 16:00,0,321,17,16,354
5/1/16 17:00,0,282,17,10,309
5/1/16 18:00,0,231,8,13,252
5/1/16 19:00,0,200,11,9,220
5/1/16 20:00,0,141,7,8,156
5/1/16 21:00,0,127,11,7,145
5/1/16 22:00,0,76,4,7,87
5/1/16 23:00,0,71,4,6,81
6/1/16 0:00,0,33,5,2,40
6/1/16 1:00,0,23,4,3,30
6/1/16 2:00,0,13,4,5,22
6/1/16 3:00,0,24,2,1,27
6/1/16 4:00,0,17,6,1,24
6/1/16 5:00,0,29,3,3,35
6/1/16 6:00,0,43,2,1,46
6/1/16 7:00,0,52,1,2,55
6/1/16 8:00,0,78,6,4,88
6/1/16 9:00,0,149,5,4,158
6/1/16 10:00,0,235,6,7,248
6/1/16 11:00,0,322,8,7,337
6/1/16 12:00,0,364,5,12,381
6/1/16 13:00,2,323,10,13,348
6/1/16 14:00,0,318,6,11,335
6/1/16 15:00,0,316,7,6,329
6/1/16 16:00,0,338,10,4,352
6/1/16 17:00,0,372,9,10,391
6/1/16 18:00,0,293,13,11,317
6/1/16 19:00,0,303,6,4,313
6/1/16 20:00,0,181,21,11,213
6/1/16 21:00,0,135,16,8,159
6/1/16 22:00,0,86,9,11,106
6/1/16 23:00,0,57,6,11,74
7/1/16 0:00,0,36,7,4,47
7/1/16 1:00,0,24,6,5,35
7/1/16 2:00,0,26,3,4,33
7/1/16 3:00,0,17,7,6,30
7/1/16 4:00,0,27,12,5,44
7/1/16 5:00,0,33,9,5,47
7/1/16 6:00,0,73,15,9,97
7/1/16 7:00,0,127,10,7,144
7/1/16 8:00,0,148,3,6,157
7/1/16 9:00,0,189,13,3,205
7/1/16 10:00,0,262,15,11,288
7/1/16 11:00,0,305,9,19,333
7/1/16 12:00,0,317,16,23,356
7/1/16 13:00,0,303,15,20,338
7/1/16 14:00,1,301,11,34,347
7/1/16 15:00,1,374,6,24,405
7/1/16 16:00,0,297,13,18,328
7/1/16 17:00,0,292,13,19,324
7/1/16 18:00,1,244,9,10,264
7/1/16 19:00,0,216,9,17,242
7/1/16 20:00,0,144,10,14,168
7/1/16 21:00,0,110,11,5,126
7/1/16 22:00,0,84,8,3,95
7/1/16 23:00,0,61,7,6,74
8/1/16 0:00,0,33,7,10,50
8/1/16 1:00,0,24,5,6,35
8/1/16 2:00,0,15,4,1,20
8/1/16 3:00,0,13,7,7,27
8/1/16 4:00,0,14,7,3,24
8/1/16 5:00,0,20,5,7,32
8/1/16 6:00,0,67,7,6,80
8/1/16 7:00,0,112,15,6,133
8/1/16 8:00,0,159,9,6,174
8/1/16 9:00,0,241,14,9,264
8/1/16 10:00,0,255,14,16,285
8/1/16 11:00,0,250,10,19,279
8/1/16 12:00,1,309,13,26,349
8/1/16 13:00,0,275,12,25,312
8/1/16 14:00,0,324,17,20,361
8/1/16 15:00,0,366,15,21,402
8/1/16 16:00,0,326,11,17,354
8/1/16 17:00,0,369,13,17,399
8/1/16 18:00,0,319,12,15,346
8/1/16 19:00,0,248,15,8,271
8/1/16 20:00,0,177,6,7,190
8/1/16 21:00,0,126,13,7,146
8/1/16 22:00,0,104,12,7,123
8/1/16 23:00,0,50,5,4,59
9/1/16 0:00,0,33,7,5,45
9/1/16 1:00,0,29,4,1,34
9/1/16 2:00,0,32,5,3,40
9/1/16 3:00,0,28,2,1,31
9/1/16 4:00,0,26,6,2,34
9/1/16 5:00,0,35,4,4,43
9/1/16 6:00,0,61,6,2,69
9/1/16 7:00,0,106,13,6,125
9/1/16 8:00,0,174,2,7,183
9/1/16 9:00,0,239,11,8,258
9/1/16 10:00,0,320,12,13,345
9/1/16 11:00,0,368,8,10,386
9/1/16 12:00,1,367,9,16,393
9/1/16 13:00,1,322,10,15,348
9/1/16 14:00,0,314,7,10,331
9/1/16 15:00,0,347,14,17,378
9/1/16 16:00,0,363,11,13,387
9/1/16 17:00,0,406,9,9,424
9/1/16 18:00,0,333,9,7,349
9/1/16 19:00,1,317,9,5,332
9/1/16 20:00,0,222,8,6,236
9/1/16 21:00,0,167,5,3,175
9/1/16 22:00,0,122,9,5,136
9/1/16 23:00,0,71,5,2,78
10/1/16 0:00,0,45,7,3,55
10/1/16 1:00,0,31,2,1,34
10/1/16 2:00,0,25,6,0,31
10/1/16 3:00,0,19,6,3,28
10/1/16 4:00,0,22,6,0,28
10/1/16 5:00,0,43,6,3,52
10/1/16 6:00,0,55,3,1,59
10/1/16 7:00,1,99,7,4,111
10/1/16 8:00,0,141,5,7,153
10/1/16 9:00,0,195,9,5,209
10/1/16 10:00,3,284,10,8,305
10/1/16 11:00,1,390,11,4,406
10/1/16 12:00,0,419,16,10,445
10/1/16 13:00,4,452,15,18,489
10/1/16 14:00,1,530,16,7,554
10/1/16 15:00,0,441,13,13,467
10/1/16 16:00,1,596,13,19,629
10/1/16 17:00,1,528,26,5,560
10/1/16 18:00,4,436,17,18,475
10/1/16 19:00,0,359,19,20,398
10/1/16 20:00,0,280,13,10,303
10/1/16 21:00,1,195,20,10,226
10/1/16 22:00,0,101,16,5,122
10/1/16 23:00,0,64,8,6,78
11/1/16 0:00,0,57,8,3,68
11/1/16 1:00,0,29,8,3,40
11/1/16 2:00,0,17,4,1,22
11/1/16 3:00,0,26,5,5,36
11/1/16 4:00,0,24,12,2,38
11/1/16 5:00,0,37,6,5,48
11/1/16 6:00,0,97,14,7,118
11/1/16 7:00,0,211,8,6,225
11/1/16 8:00,0,242,15,15,272
11/1/16 9:00,1,271,13,9,294
11/1/16 10:00,1,297,14,18,330
11/1/16 11:00,0,258,10,22,290
11/1/16 12:00,0,250,15,23,288
11/1/16 13:00,1,257,12,22,292
11/1/16 14:00,0,243,17,22,282
11/1/16 15:00,0,296,11,23,330
11/1/16 16:00,1,287,12,14,314
11/1/16 17:00,1,258,12,17,288
11/1/16 18:00,0,219,16,21,256
11/1/16 19:00,0,170,15,9,194
11/1/16 20:00,0,132,6,15,153
11/1/16 21:00,0,114,12,6,132
11/1/16 22:00,0,59,12,6,77
11/1/16 23:00,0,41,8,4,53
12/1/16 0:00,0,43,7,3,53
12/1/16 1:00,0,19,3,3,25
12/1/16 2:00,0,19,5,2,26
12/1/16 3:00,0,13,4,3,20
12/1/16 4:00,0,17,3,8,28
12/1/16 5:00,0,28,13,9,50
12/1/16 6:00,0,73,16,9,98
12/1/16 7:00,0,140,9,8,157
12/1/16 8:00,0,202,14,7,223
12/1/16 9:00,0,273,17,9,299
12/1/16 10:00,0,253,21,17,291
12/1/16 11:00,1,216,21,15,253
12/1/16 12:00,0,210,17,19,246
12/1/16 13:00,1,239,20,22,282
12/1/16 14:00,0,277,17,36,330
12/1/16 15:00,1,278,16,16,311
12/1/16 16:00,0,261,18,26,305
12/1/16 17:00,2,232,14,9,257
12/1/16 18:00,0,213,12,12,237
12/1/16 19:00,0,155,14,16,185
12/1/16 20:00,0,130,10,8,148
12/1/16 21:00,1,110,14,12,137
12/1/16 22:00,0,72,6,3,81
12/1/16 23:00,0,66,6,6,78
13/1/16 0:00,0,29,6,12,47
13/1/16 1:00,0,15,4,5,24
13/1/16 2:00,0,20,5,2,27
13/1/16 3:00,0,23,6,4,33
13/1/16 4:00,0,15,9,5,29
13/1/16 5:00,0,17,9,13,39
13/1/16 6:00,0,69,13,26,108
13/1/16 7:00,0,126,8,21,155
13/1/16 8:00,0,192,15,14,221
13/1/16 9:00,0,234,14,15,263
13/1/16 10:00,0,225,19,25,269
13/1/16 11:00,0,208,16,23,247
13/1/16 12:00,3,204,18,26,251
13/1/16 13:00,0,241,13,28,282
13/1/16 14:00,3,223,20,23,269
13/1/16 15:00,0,285,14,17,316
13/1/16 16:00,0,274,11,23,308
13/1/16 17:00,0,273,12,17,302
13/1/16 18:00,0,203,15,15,233
13/1/16 19:00,0,190,15,14,219
13/1/16 20:00,0,162,25,17,204
13/1/16 21:00,0,101,10,15,126
13/1/16 22:00,0,63,16,14,93
13/1/16 23:00,0,48,6,9,63
14/1/16 0:00,0,28,9,8,45
14/1/16 1:00,0,32,9,5,46
14/1/16 2:00,0,17,7,1,25
14/1/16 3:00,0,13,6,1,20
14/1/16 4:00,0,28,8,5,41
14/1/16 5:00,0,35,9,12,56
14/1/16 6:00,0,80,9,17,106
14/1/16 7:00,0,123,17,9,149
14/1/16 8:00,0,205,13,9,227
14/1/16 9:00,0,254,16,7,277
14/1/16 10:00,0,240,19,17,276
14/1/16 11:00,0,223,10,20,253
14/1/16 12:00,0,255,16,22,293
14/1/16 13:00,0,237,17,23,277
14/1/16 14:00,0,233,14,25,272
14/1/16 15:00,0,275,14,9,298
14/1/16 16:00,0,278,17,26,321
14/1/16 17:00,0,261,15,17,293
14/1/16 18:00,0,200,12,16,228
14/1/16 19:00,0,205,11,20,236
14/1/16 20:00,0,145,10,7,162
14/1/16 21:00,0,135,15,8,158
14/1/16 22:00,0,83,11,11,105
14/1/16 23:00,0,53,7,10,70
15/1/16 0:00,1,34,10,5,50
15/1/16 1:00,0,27,4,3,34
15/1/16 2:00,0,25,6,4,35
15/1/16 3:00,0,26,4,6,36
15/1/16 4:00,0,25,9,14,48
15/1/16 5:00,0,27,11,12,50
15/1/16 6:00,0,71,14,17,102
15/1/16 7:00,0,121,15,11,147
15/1/16 8:00,0,168,9,15,192
15/1/16 9:00,1,270,16,22,309
15/1/16 10:00,0,269,15,22,306
15/1/16 11:00,1,243,13,34,291
15/1/16 12:00,0,255,15,46,316
15/1/16 13:00,2,264,21,27,314
15/1/16 14:00,0,315,16,46,377
15/1/16 15:00,0,393,18,23,434
15/1/16 16:00,2,417,18,16,453
15/1/16 17:00,0,382,14,19,415
15/1/16 18:00,0,343,13,12,368
15/1/16 19:00,0,267,13,10,290
15/1/16 20:00,0,188,13,6,207
15/1/16 21:00,0,136,12,8,156
15/1/16 22:00,0,99,11,9,119
15/1/16 23:00,0,69,5,9,83
16/1/16 0:00,0,51,9,5,65
16/1/16 1:00,0,32,4,1,37
16/1/16 2:00,0,25,8,5,38
16/1/16 3:00,0,26,6,2,34
16/1/16 4:00,0,25,1,2,28
16/1/16 5:00,0,38,4,1,43
16/1/16 6:00,0,64,12,6,82
16/1/16 7:00,0,106,4,8,118
16/1/16 8:00,0,162,7,6,175
16/1/16 9:00,0,279,12,12,303
16/1/16 10:00,0,280,15,13,308
16/1/16 11:00,0,312,12,12,336
16/1/16 12:00,0,332,8,13,353
16/1/16 13:00,0,292,10,18,320
16/1/16 14:00,0,268,10,10,288
16/1/16 15:00,0,281,5,13,299
16/1/16 16:00,0,303,11,12,326
16/1/16 17:00,0,282,10,9,301
16/1/16 18:00,0,229,12,11,252
16/1/16 19:00,0,190,7,12,209
16/1/16 20:00,0,153,8,9,170
16/1/16 21:00,0,139,5,4,148
16/1/16 22:00,0,90,11,2,103
16/1/16 23:00,0,69,7,2,78
17/1/16 0:00,0,30,5,3,38
17/1/16 1:00,0,34,3,4,41
17/1/16 2:00,0,17,3,4,24
17/1/16 3:00,0,19,5,3,27
17/1/16 4:00,0,23,8,2,33
17/1/16 5:00,0,29,6,1,36
17/1/16 6:00,0,48,3,3,54
17/1/16 7:00,0,72,1,6,79
17/1/16 8:00,0,102,6,3,111
17/1/16 9:00,0,152,7,9,168
17/1/16 10:00,0,191,10,10,211
17/1/16 11:00,0,224,7,16,247
17/1/16 12:00,0,250,12,15,277
17/1/16 13:00,0,265,10,19,294
17/1/16 14:00,0,318,7,16,341
17/1/16 15:00,0,285,9,15,309
17/1/16 16:00,0,356,10,10,376
17/1/16 17:00,0,333,8,15,356
17/1/16 18:00,2,332,12,9,355
17/1/16 19:00,0,296,9,13,318
17/1/16 20:00,0,243,11,16,270
17/1/16 21:00,0,171,27,20,218
17/1/16 22:00,0,100,16,9,125
17/1/16 23:00,0,70,8,10,88
18/1/16 0:00,0,40,8,15,63
18/1/16 1:00,0,30,8,3,41
18/1/16 2:00,0,12,7,3,22
18/1/16 3:00,0,17,7,3,27
18/1/16 4:00,0,16,6,6,28
18/1/16 5:00,0,28,12,16,56
18/1/16 6:00,0,83,12,12,107
18/1/16 7:00,0,129,19,14,162
18/1/16 8:00,0,160,14,11,185
18/1/16 9:00,0,183,11,10,204
18/1/16 10:00,1,202,18,21,242
18/1/16 11:00,0,179,18,25,222
18/1/16 12:00,0,172,21,25,218
18/1/16 13:00,0,195,18,21,234
18/1/16 14:00,0,192,20,23,235
18/1/16 15:00,0,199,17,20,236
18/1/16 16:00,0,213,14,17,244
18/1/16 17:00,0,189,11,18,218
18/1/16 18:00,0,136,12,17,165
18/1/16 19:00,0,109,13,27,149
18/1/16 20:00,0,84,6,19,109
18/1/16 21:00,0,87,14,11,112
18/1/16 22:00,0,43,8,3,54
18/1/16 23:00,0,34,5,2,41
19/1/16 0:00,0,33,8,3,44
19/1/16 1:00,0,28,8,1,37
19/1/16 2:00,0,16,7,5,28
19/1/16 3:00,0,6,5,2,13
19/1/16 4:00,0,8,7,9,24
19/1/16 5:00,0,15,8,12,35
19/1/16 6:00,0,55,16,9,80
19/1/16 7:00,0,115,15,8,138
19/1/16 8:00,0,176,17,14,207
19/1/16 9:00,0,230,11,10,251
19/1/16 10:00,0,206,10,15,231
19/1/16 11:00,0,183,18,26,227
19/1/16 12:00,0,149,16,22,187
19/1/16 13:00,0,198,15,25,238
19/1/16 14:00,0,225,17,25,267
19/1/16 15:00,0,245,15,18,278
19/1/16 16:00,0,190,14,18,222
19/1/16 17:00,0,190,10,25,225
19/1/16 18:00,0,129,12,19,160
19/1/16 19:00,0,122,11,17,150
19/1/16 20:00,0,103,6,12,121
19/1/16 21:00,0,87,19,9,115
19/1/16 22:00,0,71,7,10,88
19/1/16 23:00,0,43,10,13,66
20/1/16 0:00,0,22,8,6,36
20/1/16 1:00,0,9,4,7,20
20/1/16 2:00,0,14,6,3,23
20/1/16 3:00,0,6,8,7,21
20/1/16 4:00,0,10,10,2,22
20/1/16 5:00,0,17,6,7,30
20/1/16 6:00,0,59,12,10,81
20/1/16 7:00,0,80,16,11,107
20/1/16 8:00,0,135,5,15,155
20/1/16 9:00,0,193,15,9,217
20/1/16 10:00,0,189,11,18,218
20/1/16 11:00,0,169,12,20,201
20/1/16 12:00,0,166,11,23,200
20/1/16 13:00,0,153,12,23,188
20/1/16 14:00,0,173,10,20,203
20/1/16 15:00,0,218,16,16,250
20/1/16 16:00,0,215,13,10,238
20/1/16 17:00,0,196,11,13,220
20/1/16 18:00,0,161,14,11,186
20/1/16 19:00,0,151,6,16,173
20/1/16 20:00,0,94,8,9,111
20/1/16 21:00,0,60,10,9,79
20/1/16 22:00,0,129,11,5,145
20/1/16 23:00,0,57,9,4,70
21/1/16 0:00,0,35,7,11,53
21/1/16 1:00,0,18,4,7,29
21/1/16 2:00,0,9,3,4,16
21/1/16 3:00,0,11,12,6,29
21/1/16 4:00,0,11,5,4,20
21/1/16 5:00,0,17,9,10,36
21/1/16 6:00,0,30,15,14,59
21/1/16 7:00,0,99,12,14,125
21/1/16 8:00,0,128,7,11,146
21/1/16 9:00,0,186,12,10,208
21/1/16 10:00,0,173,13,16,202
21/1/16 11:00,0,139,11,18,168
21/1/16 12:00,0,155,10,18,183
21/1/16 13:00,0,135,8,12,155
21/1/16 14:00,0,125,9,8,142
21/1/16 15:00,0,206,13,28,247
21/1/16 16:00,0,172,12,18,202
21/1/16 17:00,0,229,22,34,285
21/1/16 18:00,0,168,13,14,195
21/1/16 19:00,0,131,14,12,157
21/1/16 20:00,0,77,8,15,100
21/1/16 21:00,0,76,11,8,95
21/1/16 22:00,0,63,12,9,84
21/1/16 23:00,0,52,3,12,67
22/1/16 0:00,0,33,8,7,48
22/1/16 1:00,0,15,6,3,24
22/1/16 2:00,0,18,6,6,30
22/1/16 3:00,0,21,1,5,27
22/1/16 4:00,0,10,7,0,17
22/1/16 5:00,0,20,9,3,32
22/1/16 6:00,0,54,2,18,74
22/1/16 7:00,0,95,13,7,115
22/1/16 8:00,0,143,10,5,158
22/1/16 9:00,0,150,14,17,181
22/1/16 10:00,0,184,12,23,219
22/1/16 11:00,0,169,12,24,205
22/1/16 12:00,0,33,4,4,41
22/1/16 13:00,0,0,0,0,0
22/1/16 14:00,0,178,10,28,216
22/1/16 15:00,0,205,12,20,237
22/1/16 16:00,0,191,7,17,215
22/1/16 17:00,0,355,19,25,399
22/1/16 18:00,0,181,14,4,199
22/1/16 19:00,1,157,10,9,177
22/1/16 20:00,1,107,10,11,129
22/1/16 21:00,0,98,10,13,121
22/1/16 22:00,0,67,11,5,83
22/1/16 23:00,0,43,2,5,50
23/1/16 0:00,0,25,5,7,37
23/1/16 1:00,0,23,5,4,32
23/1/16 2:00,0,14,3,1,18
23/1/16 3:00,0,16,5,3,24
23/1/16 4:00,0,24,3,3,30
23/1/16 5:00,0,23,2,3,28
23/1/16 6:00,0,67,8,4,79
23/1/16 7:00,0,89,14,2,105
23/1/16 8:00,0,128,8,5,141
23/1/16 9:00,0,182,10,4,196
23/1/16 10:00,0,153,16,13,182
23/1/16 11:00,0,157,13,10,180
23/1/16 12:00,0,59,7,4,70
23/1/16 13:00,0,64,1,3,68
23/1/16 14:00,0,213,10,10,233
23/1/16 15:00,0,157,12,7,176
23/1/16 16:00,1,141,7,5,154
23/1/16 17:00,0,143,7,24,174
23/1/16 18:00,0,117,5,5,127
23/1/16 19:00,0,123,5,7,135
23/1/16 20:00,0,101,12,3,116
23/1/16 21:00,0,79,7,7,93
23/1/16 22:00,0,55,8,4,67
23/1/16 23:00,0,28,11,4,43
24/1/16 0:00,0,29,1,3,33
24/1/16 1:00,0,19,9,2,30
24/1/16 2:00,0,15,7,2,24
24/1/16 3:00,0,11,5,2,18
24/1/16 4:00,0,20,3,2,25
24/1/16 5:00,0,19,6,1,26
24/1/16 6:00,0,54,1,3,58
24/1/16 7:00,0,57,1,0,58
24/1/16 8:00,0,69,7,0,76
24/1/16 9:00,0,111,5,8,124
24/1/16 10:00,0,154,12,7,173
24/1/16 11:00,0,157,7,2,166
24/1/16 12:00,0,1,0,0,1
24/1/16 13:00,0,10,0,0,10
24/1/16 14:00,0,222,11,7,240
24/1/16 15:00,0,232,10,10,252
24/1/16 16:00,0,230,11,9,250
24/1/16 17:00,0,228,6,19,253
24/1/16 18:00,0,187,8,10,205
24/1/16 19:00,0,163,16,10,189
24/1/16 20:00,0,123,11,13,147
24/1/16 21:00,0,89,9,12,110
24/1/16 22:00,0,66,11,5,82
24/1/16 23:00,0,68,4,4,76
25/1/16 0:00,0,36,8,11,55
25/1/16 1:00,0,16,7,9,32
25/1/16 2:00,0,10,5,4,19
25/1/16 3:00,0,17,3,0,20
25/1/16 4:00,0,16,6,3,25
25/1/16 5:00,0,23,6,9,38
25/1/16 6:00,0,68,9,8,85
25/1/16 7:00,0,143,5,3,151
25/1/16 8:00,0,137,8,5,150
25/1/16 9:00,1,156,6,13,176
25/1/16 10:00,0,195,12,12,219
25/1/16 11:00,0,164,10,24,198
25/1/16 12:00,1,93,8,18,120
25/1/16 13:00,0,54,5,1,60
25/1/16 14:00,1,102,4,6,113
25/1/16 15:00,0,178,9,23,210
25/1/16 16:00,0,183,14,21,218
25/1/16 17:00,0,161,12,8,181
25/1/16 18:00,0,120,8,22,150
25/1/16 19:00,0,97,7,10,114
25/1/16 20:00,0,84,8,11,103
25/1/16 21:00,0,82,7,8,97
25/1/16 22:00,0,83,13,4,100
25/1/16 23:00,0,56,9,8,73
26/1/16 0:00,0,33,5,8,46
26/1/16 1:00,0,17,9,2,28
26/1/16 2:00,0,10,6,4,20
26/1/16 3:00,0,11,3,1,15
26/1/16 4:00,0,15,3,5,23
26/1/16 5:00,0,16,5,5,26
26/1/16 6:00,0,61,9,5,75
26/1/16 7:00,0,129,2,10,141
26/1/16 8:00,0,135,12,7,154
26/1/16 9:00,0,195,8,13,216
26/1/16 10:00,0,174,9,24,207
26/1/16 11:00,0,157,5,24,186
26/1/16 12:00,1,78,8,20,107
26/1/16 13:00,0,73,10,4,87
26/1/16 14:00,0,147,12,12,171
26/1/16 15:00,0,162,11,15,188
26/1/16 16:00,0,172,11,21,204
26/1/16 17:00,0,147,8,7,162
26/1/16 18:00,0,49,2,4,55
26/1/16 19:00,0,0,0,0,0
26/1/16 20:00,0,50,3,8,61
26/1/16 21:00,0,88,10,7,105
26/1/16 22:00,0,93,12,15,120
26/1/16 23:00,0,32,3,7,42
27/1/16 0:00,0,25,3,7,35
27/1/16 1:00,0,15,3,7,25
27/1/16 2:00,0,13,4,5,22
27/1/16 3:00,0,12,8,3,23
27/1/16 4:00,0,15,5,3,23
27/1/16 5:00,0,25,11,5,41
27/1/16 6:00,0,49,6,11,66
27/1/16 7:00,0,98,10,12,120
27/1/16 8:00,0,147,11,16,174
27/1/16 9:00,0,164,8,8,180
27/1/16 10:00,0,150,11,15,176
27/1/16 11:00,0,131,11,17,159
27/1/16 12:00,0,86,7,16,109
27/1/16 13:00,0,52,2,1,55
27/1/16 14:00,0,144,14,7,165
27/1/16 15:00,0,279,17,44,340
27/1/16 16:00,0,198,16,30,244
27/1/16 17:00,0,193,6,27,226
27/1/16 18:00,0,115,6,20,141
27/1/16 19:00,1,49,3,1,54
27/1/16 20:00,0,103,7,4,114
27/1/16 21:00,0,97,17,20,134
27/1/16 22:00,0,82,18,11,111
27/1/16 23:00,0,43,9,6,58
28/1/16 0:00,0,26,11,10,47
28/1/16 1:00,0,20,5,4,29
28/1/16 2:00,0,15,6,1,22
28/1/16 3:00,0,16,6,4,26
28/1/16 4:00,0,15,7,5,27
28/1/16 5:00,0,25,5,5,35
28/1/16 6:00,0,60,7,12,79
28/1/16 7:00,0,111,16,7,134
28/1/16 8:00,0,174,13,7,194
28/1/16 9:00,0,215,16,10,241
28/1/16 10:00,0,221,16,12,249
28/1/16 11:00,0,166,7,31,204
28/1/16 12:00,0,135,2,16,153
28/1/16 13:00,0,109,10,12,131
28/1/16 14:00,0,194,12,25,231
28/1/16 15:00,0,258,17,14,289
28/1/16 16:00,0,242,15,19,276
28/1/16 17:00,0,218,17,17,252
28/1/16 18:00,0,169,7,26,202
28/1/16 19:00,0,117,9,12,138
28/1/16 20:00,0,94,8,14,116
28/1/16 21:00,0,90,12,6,108
28/1/16 22:00,0,67,15,7,89
28/1/16 23:00,0,61,5,12,78
29/1/16 0:00,0,42,6,7,55
29/1/16 1:00,0,24,8,4,36
29/1/16 2:00,0,24,2,8,34
29/1/16 3:00,0,22,3,2,27
29/1/16 4:00,0,16,5,2,23
29/1/16 5:00,0,37,9,13,59
29/1/16 6:00,0,80,13,10,103
29/1/16 7:00,0,148,17,11,176
29/1/16 8:00,0,236,14,15,265
29/1/16 9:00,0,277,6,18,301
29/1/16 10:00,0,292,17,19,328
29/1/16 11:00,0,211,14,19,244
29/1/16 12:00,1,136,13,21,171
29/1/16 13:00,0,85,4,2,91
29/1/16 14:00,0,218,7,13,238
29/1/16 15:00,0,406,16,37,459
29/1/16 16:00,1,371,18,19,409
29/1/16 17:00,1,404,14,15,434
29/1/16 18:00,0,215,11,15,241
29/1/16 19:00,0,151,16,6,173
29/1/16 20:00,0,155,9,11,175
29/1/16 21:00,0,180,13,6,199
29/1/16 22:00,0,147,13,6,166
29/1/16 23:00,0,80,4,7,91
30/1/16 0:00,0,46,4,5,55
30/1/16 1:00,0,32,11,8,51
30/1/16 2:00,0,20,4,2,26
30/1/16 3:00,0,32,3,2,37
30/1/16 4:00,0,25,5,6,36
30/1/16 5:00,0,41,5,2,48
30/1/16 6:00,0,75,7,11,93
30/1/16 7:00,0,142,10,12,164
30/1/16 8:00,2,309,14,8,333
30/1/16 9:00,1,332,11,14,358
30/1/16 10:00,0,323,11,10,344
30/1/16 11:00,0,231,7,8,246
30/1/16 12:00,0,140,4,13,157
30/1/16 13:00,0,49,3,6,58
30/1/16 14:00,0,234,7,3,244
30/1/16 15:00,1,249,7,16,273
30/1/16 16:00,0,286,14,8,308
30/1/16 17:00,0,238,8,12,258
30/1/16 18:00,0,151,10,7,168
30/1/16 19:00,0,138,4,4,146
30/1/16 20:00,0,165,12,1,178
30/1/16 21:00,0,166,11,14,191
30/1/16 22:00,0,134,9,1,144
30/1/16 23:00,0,101,2,3,106
31/1/16 0:00,0,55,5,5,65
31/1/16 1:00,0,43,5,2,50
31/1/16 2:00,0,21,9,3,33
31/1/16 3:00,0,31,5,3,39
31/1/16 4:00,0,24,1,1,26
31/1/16 5:00,0,34,3,2,39
31/1/16 6:00,0,38,2,2,42
31/1/16 7:00,0,126,5,2,133
31/1/16 8:00,0,213,12,5,230
31/1/16 9:00,0,244,9,3,256
31/1/16 10:00,1,246,10,6,263
31/1/16 11:00,0,256,9,4,269
31/1/16 12:00,2,177,9,7,195
31/1/16 13:00,0,91,4,0,95
31/1/16 14:00,0,267,8,8,283
31/1/16 15:00,0,371,11,27,409
31/1/16 16:00,2,410,11,4,427
31/1/16 17:00,2,375,4,4,385
31/1/16 18:00,0,242,11,4,257
31/1/16 19:00,0,182,9,4,195
31/1/16 20:00,0,186,15,3,204
31/1/16 21:00,0,212,16,6,234
31/1/16 22:00,0,170,15,9,194
31/1/16 23:00,0,114,12,6,132
1/2/16 0:00,0,58,8,13,79
1/2/16 1:00,0,35,3,3,41
1/2/16 2:00,0,21,7,6,34
1/2/16 3:00,0,14,6,5,25
1/2/16 4:00,0,23,2,4,29
1/2/16 5:00,0,45,10,8,63
1/2/16 6:00,0,99,8,17,124
1/2/16 7:00,0,175,13,10,198
1/2/16 8:00,2,220,7,20,249
1/2/16 9:00,0,237,12,8,257
1/2/16 10:00,2,200,15,26,243
1/2/16 11:00,0,196,17,22,235
1/2/16 12:00,0,151,11,17,179
1/2/16 13:00,0,84,4,12,100
1/2/16 14:00,0,164,9,9,182
1/2/16 15:00,0,218,6,42,266
1/2/16 16:00,1,110,12,16,139
1/2/16 17:00,0,82,2,12,96
1/2/16 18:00,0,71,5,9,85
1/2/16 19:00,0,33,2,4,39
1/2/16 20:00,0,70,7,2,79
1/2/16 21:00,0,198,10,20,228
1/2/16 22:00,0,164,12,22,198
1/2/16 23:00,0,61,7,1,69
2/2/16 0:00,0,49,6,5,60
2/2/16 1:00,0,29,10,8,47
2/2/16 2:00,0,21,11,6,38
2/2/16 3:00,0,20,4,4,28
2/2/16 4:00,0,14,8,6,28
2/2/16 5:00,0,32,8,5,45
2/2/16 6:00,0,71,13,9,93
2/2/16 7:00,0,137,11,8,156
2/2/16 8:00,0,169,10,16,195
2/2/16 9:00,0,204,8,14,226
2/2/16 10:00,1,201,11,20,233
2/2/16 11:00,0,135,8,13,156
2/2/16 12:00,1,143,11,13,168
2/2/16 13:00,0,63,6,3,72
2/2/16 14:00,0,159,13,3,175
2/2/16 15:00,0,186,12,39,237
2/2/16 16:00,1,139,12,21,173
2/2/16 17:00,0,90,9,5,104
2/2/16 18:00,0,57,6,6,69
2/2/16 19:00,0,48,3,0,51
2/2/16 20:00,0,72,3,3,78
2/2/16 21:00,0,178,17,33,228
2/2/16 22:00,0,129,10,25,164
2/2/16 23:00,1,53,8,14,76
3/2/16 0:00,0,44,11,9,64
3/2/16 1:00,0,14,5,10,29
3/2/16 2:00,0,19,5,9,33
3/2/16 3:00,0,20,3,2,25
3/2/16 4:00,0,21,5,5,31
3/2/16 5:00,0,46,13,5,64
3/2/16 6:00,0,97,11,13,121
3/2/16 7:00,0,125,12,17,154
3/2/16 8:00,0,169,15,13,197
3/2/16 9:00,1,177,12,19,209
3/2/16 10:00,0,186,11,17,214
3/2/16 11:00,0,137,21,18,176
3/2/16 12:00,2,125,15,18,160
3/2/16 13:00,1,94,11,10,116
3/2/16 14:00,0,156,10,17,183
3/2/16 15:00,1,235,10,40,286
3/2/16 16:00,1,248,13,26,288
3/2/16 17:00,0,123,8,15,146
3/2/16 18:00,0,74,6,6,86
3/2/16 19:00,0,56,2,5,63
3/2/16 20:00,0,87,5,1,93
3/2/16 21:00,1,226,15,20,262
3/2/16 22:00,1,128,26,15,170
3/2/16 23:00,0,66,12,7,85
4/2/16 0:00,0,57,4,10,71
4/2/16 1:00,0,22,11,9,42
4/2/16 2:00,0,23,11,8,42
4/2/16 3:00,0,22,4,2,28
4/2/16 4:00,0,18,4,9,31
4/2/16 5:00,0,34,5,3,42
4/2/16 6:00,0,35,5,4,44
4/2/16 7:00,0,70,11,2,83
4/2/16 8:00,1,86,11,8,106
4/2/16 9:00,0,105,2,8,115
4/2/16 10:00,2,110,7,8,127
4/2/16 11:00,0,113,13,7,133
4/2/16 12:00,2,101,4,8,115
4/2/16 13:00,1,99,6,8,114
4/2/16 14:00,1,74,3,3,81
4/2/16 15:00,0,83,2,7,92
4/2/16 16:00,0,75,6,7,88
4/2/16 17:00,1,116,8,3,128
4/2/16 18:00,0,115,7,13,135
4/2/16 19:00,0,92,4,9,105
4/2/16 20:00,0,78,3,2,83
4/2/16 21:00,0,59,7,14,80
4/2/16 22:00,0,72,8,6,86
4/2/16 23:00,0,36,7,8,51
5/2/16 0:00,0,29,5,8,42
5/2/16 1:00,0,17,6,8,31
5/2/16 2:00,0,16,6,8,30
5/2/16 3:00,0,21,3,1,25
5/2/16 4:00,0,25,10,4,39
5/2/16 5:00,0,30,11,6,47
5/2/16 6:00,0,68,17,9,94
5/2/16 7:00,0,125,14,6,145
5/2/16 8:00,0,146,12,18,176
5/2/16 9:00,0,161,10,15,186
5/2/16 10:00,0,189,15,9,213
5/2/16 11:00,0,193,12,12,217
5/2/16 12:00,0,133,12,22,167
5/2/16 13:00,1,167,10,20,198
5/2/16 14:00,0,184,13,32,229
5/2/16 15:00,0,240,8,15,263
5/2/16 16:00,1,264,13,8,286
5/2/16 17:00,0,168,8,10,186
5/2/16 18:00,0,94,8,3,105
5/2/16 19:00,0,82,8,6,96
5/2/16 20:00,2,76,7,6,91
5/2/16 21:00,0,249,9,21,279
5/2/16 22:00,0,130,18,8,156
5/2/16 23:00,0,57,7,3,67
6/2/16 0:00,0,38,4,5,47
6/2/16 1:00,0,37,5,10,52
6/2/16 2:00,0,19,4,12,35
6/2/16 3:00,0,26,6,6,38
6/2/16 4:00,0,29,3,3,35
6/2/16 5:00,0,32,7,4,43
6/2/16 6:00,0,74,7,3,84
6/2/16 7:00,0,98,6,6,110
6/2/16 8:00,0,127,14,4,145
6/2/16 9:00,0,192,2,13,207
6/2/16 10:00,1,236,13,8,258
6/2/16 11:00,0,165,9,16,190
6/2/16 12:00,1,71,2,5,79
6/2/16 13:00,1,19,2,2,24
6/2/16 14:00,0,34,3,0,37
6/2/16 15:00,1,76,5,1,83
6/2/16 16:00,0,65,3,35,103
6/2/16 17:00,0,69,3,4,76
6/2/16 18:00,0,39,5,2,46
6/2/16 19:00,0,32,1,2,35
6/2/16 20:00,1,27,4,0,32
6/2/16 21:00,0,43,4,6,53
6/2/16 22:00,0,29,3,4,36
6/2/16 23:00,0,25,5,1,31
7/2/16 0:00,0,18,0,1,19
7/2/16 1:00,0,19,7,7,33
7/2/16 2:00,0,14,6,6,26
7/2/16 3:00,0,12,7,6,25
7/2/16 4:00,0,10,3,2,15
7/2/16 5:00,0,14,2,0,16
7/2/16 6:00,0,21,2,3,26
7/2/16 7:00,0,52,3,3,58
7/2/16 8:00,0,54,5,12,71
7/2/16 9:00,0,78,2,4,84
7/2/16 10:00,0,109,11,9,129
7/2/16 11:00,1,174,5,22,202
7/2/16 12:00,0,186,7,8,201
7/2/16 13:00,1,127,9,2,139
7/2/16 14:00,0,128,1,3,132
7/2/16 15:00,2,249,16,16,283
7/2/16 16:00,0,227,13,3,243
7/2/16 17:00,0,201,9,4,214
7/2/16 18:00,0,173,12,13,198
7/2/16 19:00,0,116,8,8,132
7/2/16 20:00,0,127,14,7,148
7/2/16 21:00,0,137,11,11,159
7/2/16 22:00,1,80,13,5,99
7/2/16 23:00,0,84,10,8,102
8/2/16 0:00,0,40,5,9,54
8/2/16 1:00,0,35,6,7,48
8/2/16 2:00,0,18,5,6,29
8/2/16 3:00,0,19,3,4,26
8/2/16 4:00,0,17,9,6,32
8/2/16 5:00,0,37,6,7,50
8/2/16 6:00,0,98,11,15,124
8/2/16 7:00,0,170,5,14,189
8/2/16 8:00,1,165,6,12,184
8/2/16 9:00,0,158,16,6,180
8/2/16 10:00,0,184,12,17,213
8/2/16 11:00,0,170,8,22,200
8/2/16 12:00,0,96,8,9,113
8/2/16 13:00,0,51,3,2,56
8/2/16 14:00,1,52,4,5,62
8/2/16 15:00,0,66,6,1,73
8/2/16 16:00,0,85,4,8,97
8/2/16 17:00,1,88,7,28,124
8/2/16 18:00,1,65,3,7,76
8/2/16 19:00,0,73,5,2,80
8/2/16 20:00,0,49,4,9,62
8/2/16 21:00,0,55,6,1,62
8/2/16 22:00,0,61,5,10,76
8/2/16 23:00,0,38,2,7,47
9/2/16 0:00,0,48,5,24,77
9/2/16 1:00,0,34,2,7,43
9/2/16 2:00,0,25,6,11,42
9/2/16 3:00,0,19,10,3,32
9/2/16 4:00,0,18,4,9,31
9/2/16 5:00,0,28,9,12,49
9/2/16 6:00,0,50,5,10,65
9/2/16 7:00,0,93,10,11,114
9/2/16 8:00,0,148,7,6,161
9/2/16 9:00,0,177,10,16,203
9/2/16 10:00,0,156,10,18,184
9/2/16 11:00,0,125,10,17,152
9/2/16 12:00,0,97,5,20,122
9/2/16 13:00,1,52,3,2,58
9/2/16 14:00,0,93,1,1,95
9/2/16 15:00,0,74,5,3,82
9/2/16 16:00,2,78,3,2,85
9/2/16 17:00,1,139,6,31,177
9/2/16 18:00,0,86,11,16,113
9/2/16 19:00,0,87,4,5,96
9/2/16 20:00,0,69,4,10,83
9/2/16 21:00,0,50,0,2,52
9/2/16 22:00,2,45,8,4,59
9/2/16 23:00,0,44,3,9,56
10/2/16 0:00,0,47,13,33,93
10/2/16 1:00,0,15,4,14,33
10/2/16 2:00,0,23,3,17,43
10/2/16 3:00,0,21,8,7,36
10/2/16 4:00,0,26,4,21,51
10/2/16 5:00,0,24,8,10,42
10/2/16 6:00,0,60,14,16,90
10/2/16 7:00,0,127,4,13,144
10/2/16 8:00,0,123,8,17,148
10/2/16 9:00,2,157,13,9,181
10/2/16 10:00,0,171,17,19,207
10/2/16 11:00,0,121,16,27,164
10/2/16 12:00,0,102,6,16,124
10/2/16 13:00,1,76,5,4,86
10/2/16 14:00,1,87,5,2,95
10/2/16 15:00,0,94,1,6,101
10/2/16 16:00,0,134,5,15,154
10/2/16 17:00,0,141,6,18,165
10/2/16 18:00,2,106,4,8,120
10/2/16 19:00,1,76,5,4,86
10/2/16 20:00,0,92,3,4,99
10/2/16 21:00,0,55,11,4,70
10/2/16 22:00,0,58,8,7,73
10/2/16 23:00,0,50,8,2,60
11/2/16 0:00,0,42,5,54,101
11/2/16 1:00,0,37,10,19,66
11/2/16 2:00,0,19,4,12,35
11/2/16 3:00,0,14,3,10,27
11/2/16 4:00,0,14,8,12,34
11/2/16 5:00,0,36,10,12,58
11/2/16 6:00,0,70,14,12,96
11/2/16 7:00,0,115,10,16,141
11/2/16 8:00,0,180,14,7,201
11/2/16 9:00,0,199,13,17,229
11/2/16 10:00,0,164,11,20,195
11/2/16 11:00,0,151,11,26,188
11/2/16 12:00,1,85,8,19,113
11/2/16 13:00,1,65,3,3,72
11/2/16 14:00,2,102,3,5,112
11/2/16 15:00,0,127,2,5,134
11/2/16 16:00,0,163,3,18,184
11/2/16 17:00,2,156,4,28,190
11/2/16 18:00,0,130,3,9,142
11/2/16 19:00,0,104,4,5,113
11/2/16 20:00,0,75,8,2,85
11/2/16 21:00,0,65,5,4,74
11/2/16 22:00,0,55,8,1,64
11/2/16 23:00,0,58,6,9,73
12/2/16 0:00,0,45,12,38,95
12/2/16 1:00,1,51,13,18,83
12/2/16 2:00,0,30,7,10,47
12/2/16 3:00,0,19,10,12,41
12/2/16 4:00,0,26,8,9,43
12/2/16 5:00,0,44,13,12,69
12/2/16 6:00,0,62,10,12,84
12/2/16 7:00,0,142,14,10,166
12/2/16 8:00,0,164,11,12,187
12/2/16 9:00,0,204,10,15,229
12/2/16 10:00,0,232,15,16,263
12/2/16 11:00,0,211,11,21,243
12/2/16 12:00,0,19,2,1,22
12/2/16 13:00,0,0,0,0,0
12/2/16 14:00,0,194,7,15,216
12/2/16 15:00,0,212,12,19,243
12/2/16 16:00,0,270,13,13,296
12/2/16 17:00,0,259,12,15,286
12/2/16 18:00,0,242,15,7,264
12/2/16 19:00,0,126,8,7,141
12/2/16 20:00,1,199,11,18,229
12/2/16 21:00,0,116,15,7,138
12/2/16 22:00,0,98,13,7,118
12/2/16 23:00,0,68,9,3,80
13/2/16 0:00,0,32,4,9,45
13/2/16 1:00,0,33,4,6,43
13/2/16 2:00,0,17,2,3,22
13/2/16 3:00,0,23,7,4,34
13/2/16 4:00,0,24,5,5,34
13/2/16 5:00,0,30,5,8,43
13/2/16 6:00,0,53,7,1,61
13/2/16 7:00,0,101,12,3,116
13/2/16 8:00,0,163,7,8,178
13/2/16 9:00,0,151,10,9,170
13/2/16 10:00,4,215,12,11,242
13/2/16 11:00,0,215,8,15,238
13/2/16 12:00,0,114,5,7,126
13/2/16 13:00,0,79,3,1,83
13/2/16 14:00,0,146,6,5,157
13/2/16 15:00,0,135,6,5,146
13/2/16 16:00,1,139,10,7,157
13/2/16 17:00,0,149,7,8,164
13/2/16 18:00,0,111,6,1,118
13/2/16 19:00,0,163,5,14,182
13/2/16 20:00,0,96,8,5,109
13/2/16 21:00,0,93,4,6,103
13/2/16 22:00,0,57,12,1,70
13/2/16 23:00,0,41,5,5,51
14/2/16 0:00,0,45,6,2,53
14/2/16 1:00,0,21,8,4,33
14/2/16 2:00,0,24,4,6,34
14/2/16 3:00,0,20,9,1,30
14/2/16 4:00,0,8,2,6,16
14/2/16 5:00,0,28,8,6,42
14/2/16 6:00,0,44,3,3,50
14/2/16 7:00,1,73,6,2,82
14/2/16 8:00,0,109,3,6,118
14/2/16 9:00,0,148,7,8,163
14/2/16 10:00,0,201,11,18,230
14/2/16 11:00,1,173,9,12,195
14/2/16 12:00,2,150,3,5,160
14/2/16 13:00,0,109,8,1,118
14/2/16 14:00,0,160,7,3,170
14/2/16 15:00,0,206,3,22,231
14/2/16 16:00,2,242,13,5,262
14/2/16 17:00,2,218,6,6,232
14/2/16 18:00,4,248,11,4,267
14/2/16 19:00,0,165,6,3,174
14/2/16 20:00,0,160,11,1,172
14/2/16 21:00,1,116,13,9,139
14/2/16 22:00,1,119,9,21,150
14/2/16 23:00,0,88,7,10,105
15/2/16 0:00,0,70,9,6,85
15/2/16 1:00,0,49,7,3,59
15/2/16 2:00,0,22,3,4,29
15/2/16 3:00,0,24,5,11,40
15/2/16 4:00,0,25,3,6,34
15/2/16 5:00,0,51,14,10,75
15/2/16 6:00,0,101,6,12,119
15/2/16 7:00,0,180,11,8,199
15/2/16 8:00,0,222,6,9,237
15/2/16 9:00,0,214,11,18,243
15/2/16 10:00,0,213,11,17,241
15/2/16 11:00,1,166,11,22,200
15/2/16 12:00,0,74,4,11,89
15/2/16 13:00,0,66,5,3,74
15/2/16 14:00,0,100,6,3,109
15/2/16 15:00,1,152,11,7,171
15/2/16 16:00,0,139,8,5,152
15/2/16 17:00,0,164,6,12,182
15/2/16 18:00,0,148,13,10,171
15/2/16 19:00,0,90,6,5,101
15/2/16 20:00,0,91,6,3,100
15/2/16 21:00,0,67,4,6,77
15/2/16 22:00,0,77,7,3,87
15/2/16 23:00,0,50,5,3,58
16/2/16 0:00,0,44,8,19,71
16/2/16 1:00,0,29,8,6,43
16/2/16 2:00,0,19,2,7,28
16/2/16 3:00,0,15,5,8,28
16/2/16 4:00,0,20,11,5,36
16/2/16 5:00,0,34,7,10,51
16/2/16 6:00,0,63,14,9,86
16/2/16 7:00,2,159,11,12,184
16/2/16 8:00,0,207,12,10,229
16/2/16 9:00,0,196,8,10,214
16/2/16 10:00,0,190,19,17,226
16/2/16 11:00,0,174,11,14,199
16/2/16 12:00,0,73,6,14,93
16/2/16 13:00,1,81,4,2,88
16/2/16 14:00,0,91,7,1,99
16/2/16 15:00,1,191,6,15,213
16/2/16 16:00,1,146,11,2,160
16/2/16 17:00,0,166,8,6,180
16/2/16 18:00,1,112,8,5,126
16/2/16 19:00,0,108,4,9,121
16/2/16 20:00,0,79,9,8,96
16/2/16 21:00,0,77,6,7,90
16/2/16 22:00,0,63,7,4,74
16/2/16 23:00,0,51,5,5,61
17/2/16 0:00,0,31,5,37,73
17/2/16 1:00,0,31,8,6,45
17/2/16 2:00,0,20,4,4,28
17/2/16 3:00,0,22,4,4,30
17/2/16 4:00,0,11,4,5,20
17/2/16 5:00,0,25,13,8,46
17/2/16 6:00,0,84,11,20,115
17/2/16 7:00,0,139,13,12,164
17/2/16 8:00,0,159,9,17,185
17/2/16 9:00,0,232,19,23,274
17/2/16 10:00,1,186,16,35,238
17/2/16 11:00,1,150,13,22,186
17/2/16 12:00,0,101,11,7,119
17/2/16 13:00,1,77,9,4,91
17/2/16 14:00,0,86,7,1,94
17/2/16 15:00,0,149,5,11,165
17/2/16 16:00,0,168,9,8,185
17/2/16 17:00,2,164,8,7,181
17/2/16 18:00,1,125,7,5,138
17/2/16 19:00,2,89,7,0,98
17/2/16 20:00,1,95,12,0,108
17/2/16 21:00,0,78,10,7,95
17/2/16 22:00,0,62,10,5,77
17/2/16 23:00,0,50,7,3,60
18/2/16 0:00,1,43,11,59,114
18/2/16 1:00,0,29,9,12,50
18/2/16 2:00,0,23,8,4,35
18/2/16 3:00,0,19,4,5,28
18/2/16 4:00,0,25,7,5,37
18/2/16 5:00,0,46,11,7,64
18/2/16 6:00,0,68,13,16,97
18/2/16 7:00,0,119,16,12,147
18/2/16 8:00,0,208,13,13,234
18/2/16 9:00,0,169,15,23,207
18/2/16 10:00,2,197,13,10,222
18/2/16 11:00,1,169,12,17,199
18/2/16 12:00,0,95,9,5,109
18/2/16 13:00,0,71,6,1,78
18/2/16 14:00,0,106,9,0,115
18/2/16 15:00,0,168,8,11,187
18/2/16 16:00,0,204,9,10,223
18/2/16 17:00,1,156,10,20,187
18/2/16 18:00,1,103,9,1,114
18/2/16 19:00,1,73,5,2,81
18/2/16 20:00,0,70,5,0,75
18/2/16 21:00,0,116,9,3,128
18/2/16 22:00,0,68,5,2,75
18/2/16 23:00,0,54,11,40,105
19/2/16 0:00,0,33,10,16,59
19/2/16 1:00,0,49,5,10,64
19/2/16 2:00,0,26,10,7,43
19/2/16 3:00,0,20,3,7,30
19/2/16 4:00,0,21,7,7,35
19/2/16 5:00,0,32,11,8,51
19/2/16 6:00,0,74,16,9,99
19/2/16 7:00,0,124,11,9,144
19/2/16 8:00,1,171,18,13,203
19/2/16 9:00,1,247,16,15,279
19/2/16 10:00,1,255,17,12,285
19/2/16 11:00,1,239,10,17,267
19/2/16 12:00,0,137,8,11,156
19/2/16 13:00,1,106,5,3,115
19/2/16 14:00,0,119,4,1,124
19/2/16 15:00,2,261,4,6,273
19/2/16 16:00,1,290,14,7,312
19/2/16 17:00,0,260,7,11,278
19/2/16 18:00,0,158,7,3,168
19/2/16 19:00,1,118,9,1,129
19/2/16 20:00,0,144,10,2,156
19/2/16 21:00,0,121,11,3,135
19/2/16 22:00,0,81,13,2,96
19/2/16 23:00,1,80,8,9,98
20/2/16 0:00,0,54,5,10,69
20/2/16 1:00,0,31,10,6,47
20/2/16 2:00,0,24,6,4,34
20/2/16 3:00,0,17,1,3,21
20/2/16 4:00,0,33,4,1,38
20/2/16 5:00,1,32,6,5,44
20/2/16 6:00,0,80,12,3,95
20/2/16 7:00,0,89,11,1,101
20/2/16 8:00,0,153,14,5,172
20/2/16 9:00,1,214,6,8,229
20/2/16 10:00,0,231,17,10,258
20/2/16 11:00,1,207,7,5,220
20/2/16 12:00,0,145,9,12,166
20/2/16 13:00,0,78,14,4,96
20/2/16 14:00,0,113,4,3,120
20/2/16 15:00,0,116,5,8,129
20/2/16 16:00,2,147,6,3,158
20/2/16 17:00,6,154,6,15,181
20/2/16 18:00,0,108,6,3,117
20/2/16 19:00,0,125,6,6,137
20/2/16 20:00,0,110,10,3,123
20/2/16 21:00,0,70,8,7,85
20/2/16 22:00,0,59,23,3,85
20/2/16 23:00,0,53,4,4,61
21/2/16 0:00,0,36,3,2,41
21/2/16 1:00,0,32,6,1,39
21/2/16 2:00,0,19,6,1,26
21/2/16 3:00,0,21,3,3,27
21/2/16 4:00,0,20,5,3,28
21/2/16 5:00,0,24,3,4,31
21/2/16 6:00,0,54,7,2,63
21/2/16 7:00,0,73,6,1,80
21/2/16 8:00,0,109,6,3,118
21/2/16 9:00,0,176,7,6,189
21/2/16 10:00,2,195,18,11,226
21/2/16 11:00,4,203,5,15,227
21/2/16 12:00,2,133,7,4,146
21/2/16 13:00,0,134,8,0,142
21/2/16 14:00,1,141,1,0,143
21/2/16 15:00,2,227,8,16,253
21/2/16 16:00,1,258,11,5,275
21/2/16 17:00,1,235,9,3,248
21/2/16 18:00,1,234,15,0,250
21/2/16 19:00,0,183,8,4,195
21/2/16 20:00,0,155,13,10,178
21/2/16 21:00,0,133,18,13,164
21/2/16 22:00,0,113,15,14,142
21/2/16 23:00,1,80,6,44,131
22/2/16 0:00,0,48,5,5,58
22/2/16 1:00,0,48,9,13,70
22/2/16 2:00,0,29,6,12,47
22/2/16 3:00,0,16,5,9,30
22/2/16 4:00,0,20,6,7,33
22/2/16 5:00,0,43,8,7,58
22/2/16 6:00,0,87,5,13,105
22/2/16 7:00,0,203,16,14,233
22/2/16 8:00,1,226,7,17,251
22/2/16 9:00,1,229,12,10,252
22/2/16 10:00,0,217,10,13,240
22/2/16 11:00,0,176,13,22,211
22/2/16 12:00,0,147,11,12,170
22/2/16 13:00,0,120,7,5,132
22/2/16 14:00,1,134,5,5,145
22/2/16 15:00,0,177,12,32,221
22/2/16 16:00,2,173,18,20,213
22/2/16 17:00,0,177,8,26,211
22/2/16 18:00,0,158,12,18,188
22/2/16 19:00,0,97,11,5,113
22/2/16 20:00,0,101,7,12,120
22/2/16 21:00,0,95,9,8,112
22/2/16 22:00,0,71,10,7,88
22/2/16 23:00,0,64,14,8,86
23/2/16 0:00,0,41,4,11,56
23/2/16 1:00,0,30,10,10,50
23/2/16 2:00,0,17,4,11,32
23/2/16 3:00,0,17,7,4,28
23/2/16 4:00,0,18,9,4,31
23/2/16 5:00,0,20,10,11,41
23/2/16 6:00,0,73,8,19,100
23/2/16 7:00,1,134,6,11,152
23/2/16 8:00,0,219,9,17,245
23/2/16 9:00,1,237,5,18,261
23/2/16 10:00,1,252,17,9,279
23/2/16 11:00,1,160,10,23,194
23/2/16 12:00,0,127,10,15,152
23/2/16 13:00,1,100,6,5,112
23/2/16 14:00,0,124,10,4,138
23/2/16 15:00,1,212,6,23,242
23/2/16 16:00,1,164,12,8,185
23/2/16 17:00,0,169,4,8,181
23/2/16 18:00,0,126,10,6,142
23/2/16 19:00,1,106,7,5,119
23/2/16 20:00,0,122,6,8,136
23/2/16 21:00,0,88,8,6,102
23/2/16 22:00,0,67,11,4,82
23/2/16 23:00,0,46,8,7,61
24/2/16 0:00,0,39,10,35,84
24/2/16 1:00,0,33,13,14,60
24/2/16 2:00,0,20,5,13,38
24/2/16 3:00,0,14,7,1,22
24/2/16 4:00,0,22,9,8,39
24/2/16 5:00,0,39,13,9,61
24/2/16 6:00,0,75,10,15,100
24/2/16 7:00,0,130,19,15,164
24/2/16 8:00,0,200,16,20,236
24/2/16 9:00,0,224,9,16,249
24/2/16 10:00,0,212,14,23,249
24/2/16 11:00,0,189,16,27,232
24/2/16 12:00,0,123,8,16,147
24/2/16 13:00,0,89,3,3,95
24/2/16 14:00,0,100,4,5,109
24/2/16 15:00,0,197,17,20,234
24/2/16 16:00,0,169,8,14,191
24/2/16 17:00,0,202,12,13,227
24/2/16 18:00,0,129,11,9,149
24/2/16 19:00,1,152,7,19,179
24/2/16 20:00,0,109,6,4,119
24/2/16 21:00,0,93,6,6,105
24/2/16 22:00,0,69,14,7,90
24/2/16 23:00,0,53,4,11,68
25/2/16 0:00,0,23,6,3,32
25/2/16 1:00,0,34,12,20,66
25/2/16 2:00,0,18,2,17,37
25/2/16 3:00,0,24,6,8,38
25/2/16 4:00,0,29,7,5,41
25/2/16 5:00,0,37,11,14,62
25/2/16 6:00,0,87,17,19,123
25/2/16 7:00,0,132,15,11,158
25/2/16 8:00,0,207,10,13,230
25/2/16 9:00,0,212,9,17,238
25/2/16 10:00,0,216,14,10,240
25/2/16 11:00,1,182,11,31,225
25/2/16 12:00,2,139,19,19,179
25/2/16 13:00,0,157,10,18,185
25/2/16 14:00,0,152,6,17,175
25/2/16 15:00,0,186,5,15,206
25/2/16 16:00,1,168,10,19,198
25/2/16 17:00,0,211,11,9,231
25/2/16 18:00,1,158,9,11,179
25/2/16 19:00,0,125,3,3,131
25/2/16 20:00,0,113,7,3,123
25/2/16 21:00,0,78,6,5,89
25/2/16 22:00,0,76,12,9,97
25/2/16 23:00,0,48,10,25,83
26/2/16 0:00,0,28,9,16,53
26/2/16 1:00,0,39,4,11,54
26/2/16 2:00,0,26,7,7,40
26/2/16 3:00,0,30,4,4,38
26/2/16 4:00,0,24,6,12,42
26/2/16 5:00,0,30,15,11,56
26/2/16 6:00,0,76,12,15,103
26/2/16 7:00,0,131,16,14,161
26/2/16 8:00,0,184,15,9,208
26/2/16 9:00,0,210,10,13,233
26/2/16 10:00,0,248,19,22,289
26/2/16 11:00,0,262,12,26,300
26/2/16 12:00,0,198,17,24,239
26/2/16 13:00,1,202,10,19,232
26/2/16 14:00,1,243,7,12,263
26/2/16 15:00,1,308,17,15,341
26/2/16 16:00,1,271,14,15,301
26/2/16 17:00,1,319,3,8,331
26/2/16 18:00,1,329,22,4,356
26/2/16 19:00,0,230,7,2,239
26/2/16 20:00,2,180,10,6,198
26/2/16 21:00,0,152,11,2,165
26/2/16 22:00,0,98,8,3,109
26/2/16 23:00,0,84,12,28,124
27/2/16 0:00,0,41,5,7,53
27/2/16 1:00,0,31,8,6,45
27/2/16 2:00,0,34,2,4,40
27/2/16 3:00,0,30,7,3,40
27/2/16 4:00,0,33,3,4,40
27/2/16 5:00,0,50,8,6,64
27/2/16 6:00,0,75,12,7,94
27/2/16 7:00,0,116,7,7,130
27/2/16 8:00,1,167,17,12,197
27/2/16 9:00,0,249,14,15,278
27/2/16 10:00,1,292,17,11,321
27/2/16 11:00,3,288,11,10,312
27/2/16 12:00,3,227,10,13,253
27/2/16 13:00,1,205,8,15,229
27/2/16 14:00,1,178,6,16,201
27/2/16 15:00,1,206,9,5,221
27/2/16 16:00,0,245,8,10,263
27/2/16 17:00,1,266,13,3,283
27/2/16 18:00,2,209,13,10,234
27/2/16 19:00,2,188,7,10,207
27/2/16 20:00,0,131,8,4,143
27/2/16 21:00,0,88,8,10,106
27/2/16 22:00,0,61,6,2,69
27/2/16 23:00,0,68,6,3,77
28/2/16 0:00,0,43,6,4,53
28/2/16 1:00,0,32,6,2,40
28/2/16 2:00,0,26,8,2,36
28/2/16 3:00,0,26,8,4,38
28/2/16 4:00,0,21,3,1,25
28/2/16 5:00,0,31,4,1,36
28/2/16 6:00,0,47,3,1,51
28/2/16 7:00,0,97,3,3,103
28/2/16 8:00,1,158,7,6,172
28/2/16 9:00,0,189,8,7,204
28/2/16 10:00,1,239,16,2,258
28/2/16 11:00,4,263,10,8,285
28/2/16 12:00,3,235,7,5,250
28/2/16 13:00,4,251,12,3,270
28/2/16 14:00,0,288,19,10,317
28/2/16 15:00,3,307,11,9,330
28/2/16 16:00,4,373,19,10,406
28/2/16 17:00,4,396,15,10,425
28/2/16 18:00,0,389,11,14,414
28/2/16 19:00,0,311,16,10,337
28/2/16 20:00,1,245,12,9,267
28/2/16 21:00,0,202,18,10,230
28/2/16 22:00,0,116,18,14,148
28/2/16 23:00,0,86,8,4,98
29/2/16 0:00,0,43,6,9,58
29/2/16 1:00,0,30,8,3,41
29/2/16 2:00,0,24,6,4,34
29/2/16 3:00,0,22,5,2,29
29/2/16 4:00,0,20,6,14,40
29/2/16 5:00,0,29,12,13,54
29/2/16 6:00,0,84,24,23,131
29/2/16 7:00,0,158,14,12,184
29/2/16 8:00,1,209,17,19,246
29/2/16 9:00,0,273,9,20,302
29/2/16 10:00,1,199,21,11,232
29/2/16 11:00,1,219,12,30,262
29/2/16 12:00,1,205,14,30,250
29/2/16 13:00,0,202,19,28,249
29/2/16 14:00,1,194,13,30,238
29/2/16 15:00,2,200,13,19,234
29/2/16 16:00,1,210,11,13,235
29/2/16 17:00,1,209,14,13,237
29/2/16 18:00,0,210,15,14,239
29/2/16 19:00,0,177,15,13,205
29/2/16 20:00,0,140,9,11,160
29/2/16 21:00,0,110,11,7,128
29/2/16 22:00,0,76,9,18,103
29/2/16 23:00,0,53,7,7,67
1/3/16 0:00,0,27,10,12,49
1/3/16 1:00,0,24,2,9,35
1/3/16 2:00,0,18,6,7,31
1/3/16 3:00,0,13,5,5,23
1/3/16 4:00,0,19,8,4,31
1/3/16 5:00,0,20,9,13,42
1/3/16 6:00,0,75,19,19,113
1/3/16 7:00,0,164,18,11,193
1/3/16 8:00,1,230,9,11,251
1/3/16 9:00,0,249,15,17,281
1/3/16 10:00,0,231,18,24,273
1/3/16 11:00,0,199,17,23,239
1/3/16 12:00,1,202,17,22,242
1/3/16 13:00,1,238,15,31,285
1/3/16 14:00,0,282,18,24,324
1/3/16 15:00,1,321,11,26,359
1/3/16 16:00,1,300,23,21,345
1/3/16 17:00,0,262,14,21,297
1/3/16 18:00,2,223,18,20,263
1/3/16 19:00,1,198,13,22,234
1/3/16 20:00,1,132,7,18,158
1/3/16 21:00,0,115,15,19,149
1/3/16 22:00,0,95,10,14,119
1/3/16 23:00,1,139,5,13,158
2/3/16 0:00,0,71,7,8,86
2/3/16 1:00,0,32,5,5,42
2/3/16 2:00,0,22,5,5,32
2/3/16 3:00,0,23,5,10,38
2/3/16 4:00,0,15,9,11,35
2/3/16 5:00,0,37,9,5,51
2/3/16 6:00,0,66,12,9,87
2/3/16 7:00,0,146,19,16,181
2/3/16 8:00,0,221,18,17,256
2/3/16 9:00,0,239,21,10,270
2/3/16 10:00,0,242,18,34,294
2/3/16 11:00,3,223,18,27,271
2/3/16 12:00,0,230,11,21,262
2/3/16 13:00,1,234,14,38,287
2/3/16 14:00,1,233,15,29,278
2/3/16 15:00,1,267,19,27,314
2/3/16 16:00,0,280,24,29,333
2/3/16 17:00,0,256,15,18,289
2/3/16 18:00,0,216,9,13,238
2/3/16 19:00,0,186,9,9,204
2/3/16 20:00,0,139,6,14,159
2/3/16 21:00,0,88,15,14,117
2/3/16 22:00,0,62,5,11,78
2/3/16 23:00,0,46,8,13,67
3/3/16 0:00,0,40,5,5,50
3/3/16 1:00,0,29,7,11,47
3/3/16 2:00,0,17,7,4,28
3/3/16 3:00,0,20,3,4,27
3/3/16 4:00,0,18,5,10,33
3/3/16 5:00,0,35,10,8,53
3/3/16 6:00,0,63,17,12,92
3/3/16 7:00,0,154,17,14,185
3/3/16 8:00,0,205,10,9,224
3/3/16 9:00,0,273,12,15,300
3/3/16 10:00,0,257,19,24,300
3/3/16 11:00,0,283,20,17,320
3/3/16 12:00,0,310,17,20,347
3/3/16 13:00,0,294,20,16,330
3/3/16 14:00,1,341,21,25,388
3/3/16 15:00,0,424,19,18,461
3/3/16 16:00,0,444,14,20,478
3/3/16 17:00,0,411,14,15,440
3/3/16 18:00,1,393,13,16,423
3/3/16 19:00,1,299,17,20,337
3/3/16 20:00,0,200,7,16,223
3/3/16 21:00,1,130,7,14,152
3/3/16 22:00,0,123,11,5,139
3/3/16 23:00,1,69,12,3,85
4/3/16 0:00,0,48,4,9,61
4/3/16 1:00,0,27,5,2,34
4/3/16 2:00,0,19,3,8,30
4/3/16 3:00,0,20,4,4,28
4/3/16 4:00,0,28,5,0,33
4/3/16 5:00,0,55,4,5,64
4/3/16 6:00,0,84,11,11,106
4/3/16 7:00,1,134,10,5,150
4/3/16 8:00,0,219,12,8,239
4/3/16 9:00,0,284,10,11,305
4/3/16 10:00,1,355,11,21,388
4/3/16 11:00,0,344,7,16,367
4/3/16 12:00,1,299,16,13,329
4/3/16 13:00,1,261,13,10,285
4/3/16 14:00,0,270,9,18,297
4/3/16 15:00,3,269,11,24,307
4/3/16 16:00,1,339,17,10,367
4/3/16 17:00,0,321,8,7,336
4/3/16 18:00,1,300,12,11,324
4/3/16 19:00,2,304,8,6,320
4/3/16 20:00,0,196,10,11,217
4/3/16 21:00,0,148,10,4,162
4/3/16 22:00,0,91,7,5,103
4/3/16 23:00,0,88,7,4,99
5/3/16 0:00,0,63,5,3,71
5/3/16 1:00,0,55,10,2,67
5/3/16 2:00,0,40,6,1,47
5/3/16 3:00,0,38,9,5,52
5/3/16 4:00,0,33,8,3,44
5/3/16 5:00,0,33,7,1,41
5/3/16 6:00,0,62,8,0,70
5/3/16 7:00,0,133,14,3,150
5/3/16 8:00,1,173,8,7,189
5/3/16 9:00,1,202,9,7,219
5/3/16 10:00,0,253,18,17,288
5/3/16 11:00,2,307,22,11,342
5/3/16 12:00,5,304,11,10,330
5/3/16 13:00,2,315,14,17,348
5/3/16 14:00,5,354,13,21,393
5/3/16 15:00,2,438,11,12,463
5/3/16 16:00,2,436,13,15,466
5/3/16 17:00,4,538,13,25,580
5/3/16 18:00,4,534,14,17,569
5/3/16 19:00,0,422,26,20,468
5/3/16 20:00,1,299,16,12,328
5/3/16 21:00,0,204,12,13,229
5/3/16 22:00,1,140,13,1,155
5/3/16 23:00,0,87,13,13,113
6/3/16 0:00,0,52,10,6,68
6/3/16 1:00,0,34,8,4,46
6/3/16 2:00,0,16,9,3,28
6/3/16 3:00,0,26,5,10,41
6/3/16 4:00,0,24,6,5,35
6/3/16 5:00,0,50,10,3,63
6/3/16 6:00,0,134,15,14,163
6/3/16 7:00,0,234,11,7,252
6/3/16 8:00,1,257,15,14,287
6/3/16 9:00,0,281,19,15,315
6/3/16 10:00,0,274,18,19,311
6/3/16 11:00,0,252,13,42,307
6/3/16 12:00,0,244,14,32,290
6/3/16 13:00,0,229,13,35,277
6/3/16 14:00,3,248,15,16,282
6/3/16 15:00,0,207,13,31,251
6/3/16 16:00,0,249,17,27,293
6/3/16 17:00,1,233,9,25,268
6/3/16 18:00,0,203,12,21,236
6/3/16 19:00,0,181,11,10,202
6/3/16 20:00,0,144,3,7,154
6/3/16 21:00,0,108,13,13,134
6/3/16 22:00,0,74,6,15,95
6/3/16 23:00,0,59,4,6,69
7/3/16 0:00,0,27,10,12,49
7/3/16 1:00,0,27,8,5,40
7/3/16 2:00,0,12,5,3,20
7/3/16 3:00,0,15,5,3,23
7/3/16 4:00,0,17,11,9,37
7/3/16 5:00,0,32,8,11,51
7/3/16 6:00,0,73,9,18,100
7/3/16 7:00,0,172,11,10,193
7/3/16 8:00,0,245,14,15,274
7/3/16 9:00,0,296,20,20,336
7/3/16 10:00,0,234,15,24,273
7/3/16 11:00,1,201,12,25,239
7/3/16 12:00,0,211,10,35,256
7/3/16 13:00,1,225,12,30,268
7/3/16 14:00,0,240,17,26,283
7/3/16 15:00,1,228,14,12,255
7/3/16 16:00,0,238,16,27,281
7/3/16 17:00,2,236,9,15,262
7/3/16 18:00,1,213,15,15,244
7/3/16 19:00,1,180,12,13,206
7/3/16 20:00,0,145,8,15,168
7/3/16 21:00,1,98,11,20,130
7/3/16 22:00,2,80,7,20,109
7/3/16 23:00,0,52,10,14,76
8/3/16 0:00,0,24,4,5,33
8/3/16 1:00,0,16,5,7,28
8/3/16 2:00,0,19,10,3,32
8/3/16 3:00,0,17,6,4,27
8/3/16 4:00,0,10,7,6,23
8/3/16 5:00,0,37,11,12,60
8/3/16 6:00,0,98,10,15,123
8/3/16 7:00,0,155,15,11,181
8/3/16 8:00,0,220,14,11,245
8/3/16 9:00,0,280,12,21,313
8/3/16 10:00,0,247,21,32,300
8/3/16 11:00,0,213,20,29,262
8/3/16 12:00,0,219,16,19,254
8/3/16 13:00,1,263,13,32,309
8/3/16 14:00,0,276,12,33,321
8/3/16 15:00,0,283,15,23,321
8/3/16 16:00,0,287,21,20,328
8/3/16 17:00,0,302,17,20,339
8/3/16 18:00,0,222,20,11,253
8/3/16 19:00,2,233,18,17,270
8/3/16 20:00,0,172,8,14,194
8/3/16 21:00,0,124,14,16,154
8/3/16 22:00,0,95,12,14,121
8/3/16 23:00,0,51,10,11,72
9/3/16 0:00,0,45,10,11,66
9/3/16 1:00,0,29,13,10,52
9/3/16 2:00,0,21,6,9,36
9/3/16 3:00,0,16,7,2,25
9/3/16 4:00,0,25,9,11,45
9/3/16 5:00,0,37,10,7,54
9/3/16 6:00,0,72,12,20,104
9/3/16 7:00,0,160,21,25,206
9/3/16 8:00,0,240,14,10,264
9/3/16 9:00,0,278,12,19,309
9/3/16 10:00,1,252,23,15,291
9/3/16 11:00,0,251,18,25,294
9/3/16 12:00,0,260,14,27,301
9/3/16 13:00,0,274,22,20,316
9/3/16 14:00,1,279,14,36,330
9/3/16 15:00,0,319,21,37,377
9/3/16 16:00,0,350,24,16,390
9/3/16 17:00,1,297,23,18,339
9/3/16 18:00,0,270,19,25,314
9/3/16 19:00,0,232,14,12,258
9/3/16 20:00,0,169,10,15,194
9/3/16 21:00,0,133,12,6,151
9/3/16 22:00,0,121,12,10,143
9/3/16 23:00,0,66,7,14,87
10/3/16 0:00,0,52,7,7,66
10/3/16 1:00,0,48,8,6,62
10/3/16 2:00,0,25,9,5,39
10/3/16 3:00,0,28,6,8,42
10/3/16 4:00,0,28,7,8,43
10/3/16 5:00,0,27,5,7,39
10/3/16 6:00,0,65,15,16,96
10/3/16 7:00,1,167,18,18,204
10/3/16 8:00,0,203,18,15,236
10/3/16 9:00,0,243,23,18,284
10/3/16 10:00,0,328,26,13,367
10/3/16 11:00,1,328,24,28,381
10/3/16 12:00,0,386,21,33,440
10/3/16 13:00,0,387,26,23,436
10/3/16 14:00,1,440,25,13,479
10/3/16 15:00,2,531,21,20,574
10/3/16 16:00,2,703,23,19,747
10/3/16 17:00,1,717,25,19,762
10/3/16 18:00,0,671,27,13,711
10/3/16 19:00,2,498,29,12,541
10/3/16 20:00,0,399,17,15,431
10/3/16 21:00,1,322,13,10,346
10/3/16 22:00,1,211,13,9,234
10/3/16 23:00,0,133,17,6,156
11/3/16 0:00,1,69,13,8,91
11/3/16 1:00,1,41,7,2,51
11/3/16 2:00,0,49,7,2,58
11/3/16 3:00,0,30,6,6,42
11/3/16 4:00,0,28,10,7,45
11/3/16 5:00,1,66,8,8,83
11/3/16 6:00,0,90,10,6,106
11/3/16 7:00,0,146,16,12,174
11/3/16 8:00,0,183,11,5,199
11/3/16 9:00,3,337,19,12,371
11/3/16 10:00,0,496,23,10,529
11/3/16 11:00,3,609,24,17,653
11/3/16 12:00,1,628,16,14,659
11/3/16 13:00,0,558,28,16,602
11/3/16 14:00,2,482,19,7,510
11/3/16 15:00,1,423,21,15,460
11/3/16 16:00,0,487,21,4,512
11/3/16 17:00,1,520,21,10,552
11/3/16 18:00,0,407,14,3,424
11/3/16 19:00,1,375,10,8,394
11/3/16 20:00,0,271,7,5,283
11/3/16 21:00,0,201,8,8,217
11/3/16 22:00,0,141,8,3,152
11/3/16 23:00,0,113,6,5,124
12/3/16 0:00,0,76,5,3,84
12/3/16 1:00,0,55,5,3,63
12/3/16 2:00,0,29,3,2,34
12/3/16 3:00,0,34,5,5,44
12/3/16 4:00,0,30,8,1,39
12/3/16 5:00,0,31,7,2,40
12/3/16 6:00,0,55,2,8,65
12/3/16 7:00,0,97,10,6,113
12/3/16 8:00,0,154,11,3,168
12/3/16 9:00,1,239,41,12,293
12/3/16 10:00,0,369,66,15,450
12/3/16 11:00,0,473,25,10,508
12/3/16 12:00,1,439,18,13,471
12/3/16 13:00,1,339,19,30,389
12/3/16 14:00,1,293,8,17,319
12/3/16 15:00,0,272,11,17,300
12/3/16 16:00,0,302,5,16,323
12/3/16 17:00,1,403,14,13,431
12/3/16 18:00,0,395,30,10,435
12/3/16 19:00,0,349,16,1,366
12/3/16 20:00,0,289,13,6,308
12/3/16 21:00,0,202,16,1,219
12/3/16 22:00,0,130,12,3,145
12/3/16 23:00,0,88,6,3,97
13/3/16 0:00,0,71,12,9,92
13/3/16 1:00,0,41,11,6,58
13/3/16 2:00,0,32,3,0,35
13/3/16 3:00,0,11,4,0,15
13/3/16 4:00,0,16,3,2,21
13/3/16 5:00,0,20,4,3,27
13/3/16 6:00,0,27,2,3,32
13/3/16 7:00,0,52,3,2,57
13/3/16 8:00,0,84,5,4,93
13/3/16 9:00,0,106,13,6,125
13/3/16 10:00,0,199,13,9,221
13/3/16 11:00,0,336,18,9,363
13/3/16 12:00,2,400,9,10,421
13/3/16 13:00,0,444,12,20,476
13/3/16 14:00,2,542,8,12,564
13/3/16 15:00,0,676,9,2,687
13/3/16 16:00,4,878,14,8,904
13/3/16 17:00,1,964,17,12,994
13/3/16 18:00,1,814,21,10,846
13/3/16 19:00,0,732,15,9,756
13/3/16 20:00,1,473,22,7,503
13/3/16 21:00,0,340,29,14,383
13/3/16 22:00,0,180,10,9,199
13/3/16 23:00,0,89,3,8,100
14/3/16 0:00,0,60,9,6,75
14/3/16 1:00,0,46,10,4,60
14/3/16 2:00,0,23,6,11,40
14/3/16 3:00,0,16,7,5,28
14/3/16 4:00,0,19,8,6,33
14/3/16 5:00,0,50,7,5,62
14/3/16 6:00,0,144,12,15,171
14/3/16 7:00,0,254,13,12,279
14/3/16 8:00,0,329,9,12,350
14/3/16 9:00,1,353,15,14,383
14/3/16 10:00,0,336,15,18,369
14/3/16 11:00,0,311,19,33,363
14/3/16 12:00,2,321,14,25,362
14/3/16 13:00,0,301,19,35,355
14/3/16 14:00,2,333,15,20,370
14/3/16 15:00,2,304,17,21,344
14/3/16 16:00,0,329,22,27,378
14/3/16 17:00,0,293,11,24,328
14/3/16 18:00,0,257,15,20,292
14/3/16 19:00,1,164,12,9,186
14/3/16 20:00,1,141,10,30,182
14/3/16 21:00,0,130,16,15,161
14/3/16 22:00,0,90,9,10,109
14/3/16 23:00,0,59,6,11,76
15/3/16 0:00,0,34,11,9,54
15/3/16 1:00,0,22,8,10,40
15/3/16 2:00,0,19,7,2,28
15/3/16 3:00,0,10,5,5,20
15/3/16 4:00,0,19,12,6,37
15/3/16 5:00,0,42,9,8,59
15/3/16 6:00,0,82,10,19,111
15/3/16 7:00,0,175,10,19,204
15/3/16 8:00,0,245,11,14,270
15/3/16 9:00,0,271,20,19,310
15/3/16 10:00,0,223,16,28,267
15/3/16 11:00,2,243,14,28,287
15/3/16 12:00,0,208,18,29,255
15/3/16 13:00,1,213,12,37,263
15/3/16 14:00,0,225,14,20,259
15/3/16 15:00,1,246,21,20,288
15/3/16 16:00,0,258,21,30,309
15/3/16 17:00,0,251,15,15,281
15/3/16 18:00,1,229,11,13,254
15/3/16 19:00,0,200,20,21,241
15/3/16 20:00,0,140,5,14,159
15/3/16 21:00,0,108,12,15,135
15/3/16 22:00,0,74,12,13,99
15/3/16 23:00,0,48,7,7,62
16/3/16 0:00,0,37,11,15,63
16/3/16 1:00,0,26,8,6,40
16/3/16 2:00,0,13,6,3,22
16/3/16 3:00,0,18,7,6,31
16/3/16 4:00,0,20,5,4,29
16/3/16 5:00,0,33,16,9,58
16/3/16 6:00,0,64,20,18,102
16/3/16 7:00,0,142,17,17,176
16/3/16 8:00,0,198,11,12,221
16/3/16 9:00,0,279,17,22,318
16/3/16 10:00,0,253,22,16,291
16/3/16 11:00,0,245,14,22,281
16/3/16 12:00,1,189,27,26,243
16/3/16 13:00,0,204,20,31,255
16/3/16 14:00,0,243,18,37,298
16/3/16 15:00,1,289,16,27,333
16/3/16 16:00,1,269,19,25,314
16/3/16 17:00,1,233,14,16,264
16/3/16 18:00,0,221,20,19,260
16/3/16 19:00,0,156,12,17,185
16/3/16 20:00,0,144,5,10,159
16/3/16 21:00,0,107,13,15,135
16/3/16 22:00,0,86,14,22,122
16/3/16 23:00,0,49,8,13,70
17/3/16 0:00,0,36,5,10,51
17/3/16 1:00,0,29,10,7,46
17/3/16 2:00,0,20,4,12,36
17/3/16 3:00,0,32,7,5,44
17/3/16 4:00,0,14,5,3,22
17/3/16 5:00,0,38,17,13,68
17/3/16 6:00,0,72,4,16,92
17/3/16 7:00,0,147,20,16,183
17/3/16 8:00,0,189,24,18,231
17/3/16 9:00,6,221,27,18,272
17/3/16 10:00,1,273,31,27,332
17/3/16 11:00,0,268,18,32,318
17/3/16 12:00,0,257,24,29,310
17/3/16 13:00,1,262,21,48,332
17/3/16 14:00,1,345,18,23,387
17/3/16 15:00,0,358,24,15,397
17/3/16 16:00,0,421,22,32,475
17/3/16 17:00,0,378,14,19,411
17/3/16 18:00,0,333,12,17,362
17/3/16 19:00,1,217,21,14,253
17/3/16 20:00,0,228,11,7,246
17/3/16 21:00,1,155,13,9,178
17/3/16 22:00,0,111,9,7,127
17/3/16 23:00,0,63,5,8,76
18/3/16 0:00,0,54,10,7,71
18/3/16 1:00,0,35,3,7,45
18/3/16 2:00,0,25,9,4,38
18/3/16 3:00,0,22,4,2,28
18/3/16 4:00,0,20,6,1,27
18/3/16 5:00,0,37,10,7,54
18/3/16 6:00,0,82,13,14,109
18/3/16 7:00,0,157,19,8,184
18/3/16 8:00,0,185,14,8,207
18/3/16 9:00,0,258,15,10,283
18/3/16 10:00,2,277,15,15,309
18/3/16 11:00,3,314,10,10,337
18/3/16 12:00,2,290,13,12,317
18/3/16 13:00,0,238,10,21,269
18/3/16 14:00,3,244,11,15,273
18/3/16 15:00,1,274,12,19,306
18/3/16 16:00,0,318,13,8,339
18/3/16 17:00,0,274,16,20,310
18/3/16 18:00,0,256,32,7,295
18/3/16 19:00,1,208,27,3,239
18/3/16 20:00,0,175,9,7,191
18/3/16 21:00,1,125,8,6,140
18/3/16 22:00,1,102,6,4,113
18/3/16 23:00,0,72,2,3,77
19/3/16 0:00,0,40,9,2,51
19/3/16 1:00,0,24,7,8,39
19/3/16 2:00,0,17,7,5,29
19/3/16 3:00,0,21,8,2,31
19/3/16 4:00,0,26,8,1,35
19/3/16 5:00,0,25,7,0,32
19/3/16 6:00,0,64,6,3,73
19/3/16 7:00,0,75,6,5,86
19/3/16 8:00,3,117,5,0,125
19/3/16 9:00,0,172,12,16,200
19/3/16 10:00,1,200,14,17,232
19/3/16 11:00,1,266,14,16,297
19/3/16 12:00,4,252,15,22,293
19/3/16 13:00,2,292,16,28,338
19/3/16 14:00,1,293,14,18,326
19/3/16 15:00,1,316,31,12,360
19/3/16 16:00,1,390,40,17,448
19/3/16 17:00,0,396,11,11,418
19/3/16 18:00,8,415,21,19,463
19/3/16 19:00,0,321,16,11,348
19/3/16 20:00,0,284,15,15,314
19/3/16 21:00,0,220,18,14,252
19/3/16 22:00,1,134,15,10,160
19/3/16 23:00,0,80,10,8,98
20/3/16 0:00,0,60,15,6,81
20/3/16 1:00,0,48,5,3,56
20/3/16 2:00,0,16,6,4,26
20/3/16 3:00,0,18,10,4,32
20/3/16 4:00,0,15,12,7,34
20/3/16 5:00,0,43,7,8,58
20/3/16 6:00,0,126,14,13,153
20/3/16 7:00,0,214,9,9,232
20/3/16 8:00,0,262,9,15,286
20/3/16 9:00,2,299,21,19,341
20/3/16 10:00,0,238,15,24,277
20/3/16 11:00,3,214,20,24,261
20/3/16 12:00,1,210,20,31,262
20/3/16 13:00,0,230,18,29,277
20/3/16 14:00,1,226,24,19,270
20/3/16 15:00,0,199,11,20,230
20/3/16 16:00,1,244,17,30,292
20/3/16 17:00,0,211,15,25,251
20/3/16 18:00,0,210,11,16,237
20/3/16 19:00,0,159,9,17,185
20/3/16 20:00,1,158,7,11,177
20/3/16 21:00,0,109,14,20,143
20/3/16 22:00,0,70,10,11,91
20/3/16 23:00,0,58,6,13,77
21/3/16 0:00,0,45,9,6,60
21/3/16 1:00,0,32,11,5,48
21/3/16 2:00,0,12,5,4,21
21/3/16 3:00,0,15,9,3,27
21/3/16 4:00,0,11,9,4,24
21/3/16 5:00,0,34,9,15,58
21/3/16 6:00,0,74,12,19,105
21/3/16 7:00,0,200,21,16,237
21/3/16 8:00,0,252,13,11,276
21/3/16 9:00,1,300,19,12,332
21/3/16 10:00,0,236,14,18,268
21/3/16 11:00,2,215,17,18,252
21/3/16 12:00,2,200,17,23,242
21/3/16 13:00,0,218,20,20,258
21/3/16 14:00,2,225,15,18,260
21/3/16 15:00,2,251,13,24,290
21/3/16 16:00,3,250,10,18,281
21/3/16 17:00,0,206,17,24,247
21/3/16 18:00,0,230,17,15,262
21/3/16 19:00,0,171,21,12,204
21/3/16 20:00,1,142,9,11,163
21/3/16 21:00,0,113,14,16,143
21/3/16 22:00,0,84,16,8,108
21/3/16 23:00,0,52,5,10,67
22/3/16 0:00,0,38,11,8,57
22/3/16 1:00,0,27,7,3,37
22/3/16 2:00,0,16,8,5,29
22/3/16 3:00,0,19,2,8,29
22/3/16 4:00,0,23,13,6,42
22/3/16 5:00,0,35,12,17,64
22/3/16 6:00,0,74,17,19,110
22/3/16 7:00,0,181,20,16,217
22/3/16 8:00,1,218,15,20,254
22/3/16 9:00,0,251,17,11,279
22/3/16 10:00,1,238,15,23,277
22/3/16 11:00,2,206,20,30,258
22/3/16 12:00,0,246,18,26,290
22/3/16 13:00,0,232,14,27,273
22/3/16 14:00,0,274,18,35,327
22/3/16 15:00,0,312,17,17,346
22/3/16 16:00,1,300,16,23,340
22/3/16 17:00,0,269,11,16,296
22/3/16 18:00,1,244,12,22,279
22/3/16 19:00,2,201,15,14,232
22/3/16 20:00,0,186,7,13,206
22/3/16 21:00,0,138,16,17,171
22/3/16 22:00,0,108,10,10,128
22/3/16 23:00,0,79,9,16,104
23/3/16 0:00,0,45,11,16,72
23/3/16 1:00,0,18,7,5,30
23/3/16 2:00,0,21,5,7,33
23/3/16 3:00,0,20,5,3,28
23/3/16 4:00,0,15,14,8,37
23/3/16 5:00,0,35,7,13,55
23/3/16 6:00,0,77,15,21,113
23/3/16 7:00,0,156,19,22,197
23/3/16 8:00,0,220,17,15,252
23/3/16 9:00,0,242,17,12,271
23/3/16 10:00,0,274,17,24,315
23/3/16 11:00,0,292,15,25,332
23/3/16 12:00,0,344,10,28,382
23/3/16 13:00,1,366,18,43,428
23/3/16 14:00,3,476,20,26,525
23/3/16 15:00,0,488,17,34,539
23/3/16 16:00,1,546,26,29,602
23/3/16 17:00,1,521,16,13,551
23/3/16 18:00,0,490,18,14,522
23/3/16 19:00,0,397,19,9,425
23/3/16 20:00,0,304,13,10,327
23/3/16 21:00,0,254,9,6,269
23/3/16 22:00,1,165,11,4,181
23/3/16 23:00,0,100,6,9,115
24/3/16 0:00,0,59,7,6,72
24/3/16 1:00,0,46,6,3,55
24/3/16 2:00,0,25,5,6,36
24/3/16 3:00,0,21,4,5,30
24/3/16 4:00,0,17,4,1,22
24/3/16 5:00,0,40,3,0,43
24/3/16 6:00,0,49,4,5,58
24/3/16 7:00,0,95,7,4,106
24/3/16 8:00,0,180,5,3,188
24/3/16 9:00,3,252,7,6,268
24/3/16 10:00,1,407,5,7,420
24/3/16 11:00,0,505,8,9,522
24/3/16 12:00,1,500,7,6,514
24/3/16 13:00,0,371,10,12,393
24/3/16 14:00,1,288,7,18,314
24/3/16 15:00,2,257,11,13,283
24/3/16 16:00,0,227,9,13,249
24/3/16 17:00,0,269,7,6,282
24/3/16 18:00,0,211,8,3,222
24/3/16 19:00,0,176,8,3,187
24/3/16 20:00,0,121,5,6,132
24/3/16 21:00,0,83,10,6,99
24/3/16 22:00,0,65,7,2,74
24/3/16 23:00,0,50,6,5,61
25/3/16 0:00,0,56,8,4,68
25/3/16 1:00,0,17,4,3,24
25/3/16 2:00,0,14,7,5,26
25/3/16 3:00,0,19,1,1,21
25/3/16 4:00,0,18,8,3,29
25/3/16 5:00,0,31,5,4,40
25/3/16 6:00,1,54,8,2,65
25/3/16 7:00,0,94,14,6,114
25/3/16 8:00,0,184,17,12,213
25/3/16 9:00,0,234,12,12,258
25/3/16 10:00,4,251,10,14,279
25/3/16 11:00,0,311,15,8,334
25/3/16 12:00,2,301,7,11,321
25/3/16 13:00,0,265,12,23,300
25/3/16 14:00,0,235,8,16,259
25/3/16 15:00,0,264,8,13,285
25/3/16 16:00,1,304,13,16,334
25/3/16 17:00,0,277,11,14,302
25/3/16 18:00,1,276,5,11,293
25/3/16 19:00,5,292,9,8,314
25/3/16 20:00,0,199,11,5,215
25/3/16 21:00,0,173,6,2,181
25/3/16 22:00,0,93,9,5,107
25/3/16 23:00,0,59,3,2,64
26/3/16 0:00,0,44,7,2,53
26/3/16 1:00,0,28,6,1,35
26/3/16 2:00,0,22,5,4,31
26/3/16 3:00,0,26,4,3,33
26/3/16 4:00,0,29,4,2,35
26/3/16 5:00,0,27,6,0,33
26/3/16 6:00,0,45,5,7,57
26/3/16 7:00,0,86,9,3,98
26/3/16 8:00,0,123,14,9,146
26/3/16 9:00,0,148,9,7,164
26/3/16 10:00,0,223,15,5,243
26/3/16 11:00,2,327,15,10,354
26/3/16 12:00,1,396,16,14,427
26/3/16 13:00,2,472,10,19,503
26/3/16 14:00,2,511,17,12,542
26/3/16 15:00,0,583,12,15,610
26/3/16 16:00,0,717,18,9,744
26/3/16 17:00,1,798,16,19,834
26/3/16 18:00,0,768,19,14,801
26/3/16 19:00,1,580,23,6,610
26/3/16 20:00,0,462,18,8,488
26/3/16 21:00,0,324,21,8,353
26/3/16 22:00,3,180,19,7,209
26/3/16 23:00,0,87,11,3,101
27/3/16 0:00,0,74,9,6,89
27/3/16 1:00,1,39,6,7,53
27/3/16 2:00,0,28,7,8,43
27/3/16 3:00,0,21,3,3,27
27/3/16 4:00,0,29,10,4,43
27/3/16 5:00,1,52,10,7,70
27/3/16 6:00,0,120,10,17,147
27/3/16 7:00,0,213,15,10,238
27/3/16 8:00,1,276,9,7,293
27/3/16 9:00,1,281,18,19,319
27/3/16 10:00,2,236,17,23,278
27/3/16 11:00,2,257,15,23,297
27/3/16 12:00,1,262,17,23,303
27/3/16 13:00,1,243,18,31,293
27/3/16 14:00,2,253,13,32,300
27/3/16 15:00,2,235,17,18,272
27/3/16 16:00,0,297,16,26,339
27/3/16 17:00,0,255,9,30,294
27/3/16 18:00,1,237,10,8,256
27/3/16 19:00,0,184,14,7,205
27/3/16 20:00,0,160,6,17,183
27/3/16 21:00,0,126,9,10,145
27/3/16 22:00,0,97,10,11,118
27/3/16 23:00,0,66,8,9,83
28/3/16 0:00,0,43,11,14,68
28/3/16 1:00,0,25,8,1,34
28/3/16 2:00,0,20,5,7,32
28/3/16 3:00,0,27,9,1,37
28/3/16 4:00,0,24,10,7,41
28/3/16 5:00,0,29,10,4,43
28/3/16 6:00,0,67,14,20,101
28/3/16 7:00,0,170,23,15,208
28/3/16 8:00,0,250,10,16,276
28/3/16 9:00,0,289,23,11,323
28/3/16 10:00,1,231,17,19,268
28/3/16 11:00,2,199,16,23,240
28/3/16 12:00,2,203,17,23,245
28/3/16 13:00,1,232,21,29,283
28/3/16 14:00,0,212,22,20,254
28/3/16 15:00,0,248,18,28,294
28/3/16 16:00,0,241,18,14,273
28/3/16 17:00,1,216,10,20,247
28/3/16 18:00,1,196,13,18,228
28/3/16 19:00,0,176,19,19,214
28/3/16 20:00,0,128,15,16,159
28/3/16 21:00,0,116,17,10,143
28/3/16 22:00,1,112,8,19,140
28/3/16 23:00,0,56,7,11,74
29/3/16 0:00,1,43,8,8,60
29/3/16 1:00,0,24,5,7,36
29/3/16 2:00,0,20,6,3,29
29/3/16 3:00,0,24,6,7,37
29/3/16 4:00,0,17,9,6,32
29/3/16 5:00,0,31,9,12,52
29/3/16 6:00,0,81,22,21,124
29/3/16 7:00,0,170,15,11,196
29/3/16 8:00,0,208,5,7,220
29/3/16 9:00,1,264,16,13,294
29/3/16 10:00,1,199,16,14,230
29/3/16 11:00,0,226,21,23,270
29/3/16 12:00,0,216,16,28,260
29/3/16 13:00,0,223,14,15,252
29/3/16 14:00,3,256,11,18,288
29/3/16 15:00,2,268,12,21,303
29/3/16 16:00,0,295,17,10,322
29/3/16 17:00,1,283,14,19,317
29/3/16 18:00,2,229,12,23,266
29/3/16 19:00,2,216,15,16,249
29/3/16 20:00,0,180,10,9,199
29/3/16 21:00,2,133,11,11,157
29/3/16 22:00,0,93,15,17,125
29/3/16 23:00,0,48,8,10,66
30/3/16 0:00,0,42,8,8,58
30/3/16 1:00,0,23,3,8,34
30/3/16 2:00,0,12,10,6,28
30/3/16 3:00,1,18,10,5,34
30/3/16 4:00,0,23,9,12,44
30/3/16 5:00,0,27,10,8,45
30/3/16 6:00,0,74,25,26,125
30/3/16 7:00,0,131,24,16,171
30/3/16 8:00,0,229,19,12,260
30/3/16 9:00,1,262,25,18,306
30/3/16 10:00,0,231,31,9,271
30/3/16 11:00,1,247,18,28,294
30/3/16 12:00,2,207,18,28,255
30/3/16 13:00,1,231,30,21,283
30/3/16 14:00,1,230,27,22,280
30/3/16 15:00,0,286,20,26,332
30/3/16 16:00,0,258,15,26,299
30/3/16 17:00,12,238,14,18,282
30/3/16 18:00,0,248,23,17,288
30/3/16 19:00,0,201,13,14,228
30/3/16 20:00,2,161,7,14,184
30/3/16 21:00,0,141,15,7,163
30/3/16 22:00,0,86,13,10,109
30/3/16 23:00,0,62,6,17,85
31/3/16 0:00,0,49,7,7,63
31/3/16 1:00,0,30,5,4,39
31/3/16 2:00,0,23,4,6,33
31/3/16 3:00,0,27,8,5,40
31/3/16 4:00,0,22,7,9,38
31/3/16 5:00,0,31,9,9,49
31/3/16 6:00,0,49,10,14,73
31/3/16 7:00,0,131,20,25,176
31/3/16 8:00,0,206,17,7,230
31/3/16 9:00,0,243,21,21,285
31/3/16 10:00,0,272,22,22,316
31/3/16 11:00,0,253,15,29,297
31/3/16 12:00,1,285,27,22,335
31/3/16 13:00,6,324,15,35,380
31/3/16 14:00,2,319,17,19,357
31/3/16 15:00,3,394,20,20,437
31/3/16 16:00,0,413,22,15,450
31/3/16 17:00,7,416,15,13,451
31/3/16 18:00,5,354,11,12,382
31/3/16 19:00,0,324,21,4,349
31/3/16 20:00,0,241,15,9,265
31/3/16 21:00,1,177,12,12,202
31/3/16 22:00,1,114,11,5,131
31/3/16 23:00,0,91,14,10,115
1/4/16 0:00,0,67,8,4,79
1/4/16 1:00,0,39,7,5,51
1/4/16 2:00,0,27,8,3,38
1/4/16 3:00,0,34,3,6,43
1/4/16 4:00,0,37,6,2,45
1/4/16 5:00,1,43,7,8,59
1/4/16 6:00,0,83,14,6,103
1/4/16 7:00,1,134,13,3,151
1/4/16 8:00,0,187,16,11,214
1/4/16 9:00,0,282,18,10,310
1/4/16 10:00,2,307,15,18,342
1/4/16 11:00,0,345,13,16,374
1/4/16 12:00,0,281,13,14,308
1/4/16 13:00,0,330,11,29,370
1/4/16 14:00,2,271,14,11,298
1/4/16 15:00,0,277,8,11,296
1/4/16 16:00,1,313,16,16,346
1/4/16 17:00,4,314,19,7,344
1/4/16 18:00,1,278,21,2,302
1/4/16 19:00,0,242,12,12,266
1/4/16 20:00,2,175,4,2,183
1/4/16 21:00,2,126,13,7,148
1/4/16 22:00,0,96,5,5,106
1/4/16 23:00,0,70,6,5,81
2/4/16 0:00,0,38,5,4,47
2/4/16 1:00,0,35,6,4,45
2/4/16 2:00,0,16,5,1,22
2/4/16 3:00,0,19,2,1,22
2/4/16 4:00,0,30,2,3,35
2/4/16 5:00,0,29,12,2,43
2/4/16 6:00,0,68,4,2,74
2/4/16 7:00,0,78,7,5,90
2/4/16 8:00,0,140,18,9,167
2/4/16 9:00,0,168,13,6,187
2/4/16 10:00,21,232,14,10,277
2/4/16 11:00,4,254,10,9,277
2/4/16 12:00,2,302,7,17,328
2/4/16 13:00,4,314,16,24,358
2/4/16 14:00,4,297,15,17,333
2/4/16 15:00,5,358,16,14,393
2/4/16 16:00,1,427,15,18,461
2/4/16 17:00,16,441,13,16,486
2/4/16 18:00,3,409,18,13,443
2/4/16 19:00,3,385,14,12,414
2/4/16 20:00,4,342,23,11,380
2/4/16 21:00,4,215,22,13,254
2/4/16 22:00,2,163,15,10,190
2/4/16 23:00,0,105,9,16,130
3/4/16 0:00,0,53,6,20,79
3/4/16 1:00,0,45,9,11,65
3/4/16 2:00,0,20,3,5,28
3/4/16 3:00,0,18,9,6,33
3/4/16 4:00,0,25,6,2,33
3/4/16 5:00,0,45,8,9,62
3/4/16 6:00,0,99,11,13,123
3/4/16 7:00,0,229,15,7,251
3/4/16 8:00,0,257,9,5,271
3/4/16 9:00,2,283,13,13,311
3/4/16 10:00,1,230,19,27,277
3/4/16 11:00,0,213,14,20,247
3/4/16 12:00,5,240,13,19,277
3/4/16 13:00,2,225,12,13,252
3/4/16 14:00,0,236,15,19,270
3/4/16 15:00,3,224,13,20,260
3/4/16 16:00,3,250,17,21,291
3/4/16 17:00,2,242,7,22,273
3/4/16 18:00,0,255,10,25,290
3/4/16 19:00,0,203,15,15,233
3/4/16 20:00,0,150,7,6,163
3/4/16 21:00,0,116,16,19,151
3/4/16 22:00,0,82,6,12,100
3/4/16 23:00,0,60,6,12,78
4/4/16 0:00,0,38,5,4,47
4/4/16 1:00,0,20,5,6,31
4/4/16 2:00,0,22,4,4,30
4/4/16 3:00,0,17,11,2,30
4/4/16 4:00,0,18,9,5,32
4/4/16 5:00,0,28,9,8,45
4/4/16 6:00,0,98,17,21,136
4/4/16 7:00,0,130,16,12,158
4/4/16 8:00,0,264,16,18,298
4/4/16 9:00,0,259,23,10,292
4/4/16 10:00,1,231,23,20,275
4/4/16 11:00,0,226,20,29,275
4/4/16 12:00,2,220,13,30,265
4/4/16 13:00,1,206,18,19,244
4/4/16 14:00,1,224,10,37,272
4/4/16 15:00,1,240,11,26,278
4/4/16 16:00,1,233,21,23,278
4/4/16 17:00,0,251,15,12,278
4/4/16 18:00,1,200,12,15,228
4/4/16 19:00,1,171,13,10,195
4/4/16 20:00,1,167,8,9,185
4/4/16 21:00,0,106,13,16,135
4/4/16 22:00,0,89,5,16,110
4/4/16 23:00,0,51,8,10,69
5/4/16 0:00,0,35,10,10,55
5/4/16 1:00,1,26,5,2,34
5/4/16 2:00,0,29,6,6,41
5/4/16 3:00,0,23,4,6,33
5/4/16 4:00,0,20,7,9,36
5/4/16 5:00,0,40,12,9,61
5/4/16 6:00,0,78,20,15,113
5/4/16 7:00,0,147,22,10,179
5/4/16 8:00,1,232,11,10,254
5/4/16 9:00,0,243,17,12,272
5/4/16 10:00,0,270,18,17,305
5/4/16 11:00,0,223,28,23,274
5/4/16 12:00,2,220,15,29,266
5/4/16 13:00,0,211,15,26,252
5/4/16 14:00,1,233,18,23,275
5/4/16 15:00,3,253,15,14,285
5/4/16 16:00,2,280,19,12,313
5/4/16 17:00,3,289,13,27,332
5/4/16 18:00,0,242,14,18,274
5/4/16 19:00,4,231,15,13,263
5/4/16 20:00,0,175,9,13,197
5/4/16 21:00,0,133,14,21,168
5/4/16 22:00,0,97,10,9,116
5/4/16 23:00,0,85,7,11,103
6/4/16 0:00,0,59,9,13,81
6/4/16 1:00,0,25,5,10,40
6/4/16 2:00,0,17,7,1,25
6/4/16 3:00,0,18,5,2,25
6/4/16 4:00,0,15,4,8,27
6/4/16 5:00,0,25,14,12,51
6/4/16 6:00,0,59,14,17,90
6/4/16 7:00,0,144,23,12,179
6/4/16 8:00,1,234,25,10,270
6/4/16 9:00,1,254,26,10,291
6/4/16 10:00,0,260,22,35,317
6/4/16 11:00,2,227,15,23,267
6/4/16 12:00,0,226,21,24,271
6/4/16 13:00,2,248,24,41,315
6/4/16 14:00,3,236,29,33,301
6/4/16 15:00,4,269,15,33,321
6/4/16 16:00,4,271,18,29,322
6/4/16 17:00,0,236,19,14,269
6/4/16 18:00,2,228,19,14,263
6/4/16 19:00,1,200,15,19,235
6/4/16 20:00,2,193,6,13,214
6/4/16 21:00,0,124,10,20,154
6/4/16 22:00,1,91,14,14,120
6/4/16 23:00,0,64,10,10,84
7/4/16 0:00,0,42,8,6,56
7/4/16 1:00,0,30,6,3,39
7/4/16 2:00,0,22,3,1,26
7/4/16 3:00,0,21,6,5,32
7/4/16 4:00,0,21,6,3,30
7/4/16 5:00,0,41,7,8,56
7/4/16 6:00,0,79,13,17,109
7/4/16 7:00,0,147,21,19,187
7/4/16 8:00,1,248,19,9,277
7/4/16 9:00,3,264,29,14,310
7/4/16 10:00,2,261,17,16,296
7/4/16 11:00,0,282,21,24,327
7/4/16 12:00,0,267,19,31,317
7/4/16 13:00,3,277,16,37,333
7/4/16 14:00,1,304,18,17,340
7/4/16 15:00,1,407,18,23,449
7/4/16 16:00,2,485,23,17,527
7/4/16 17:00,3,459,17,21,500
7/4/16 18:00,1,383,22,15,421
7/4/16 19:00,2,317,14,8,341
7/4/16 20:00,0,222,17,11,250
7/4/16 21:00,0,136,13,9,158
7/4/16 22:00,0,137,12,11,160
7/4/16 23:00,0,82,8,5,95
8/4/16 0:00,0,60,8,2,70
8/4/16 1:00,0,31,6,3,40
8/4/16 2:00,0,31,7,6,44
8/4/16 3:00,0,32,3,1,36
8/4/16 4:00,0,22,5,0,27
8/4/16 5:00,0,53,6,5,64
8/4/16 6:00,0,70,12,4,86
8/4/16 7:00,0,152,16,7,175
8/4/16 8:00,0,194,16,9,219
8/4/16 9:00,2,274,21,8,305
8/4/16 10:00,0,319,23,13,355
8/4/16 11:00,0,344,23,4,371
8/4/16 12:00,4,298,16,12,330
8/4/16 13:00,1,285,16,17,319
8/4/16 14:00,0,247,10,17,274
8/4/16 15:00,2,300,5,12,319
8/4/16 16:00,1,299,12,11,323
8/4/16 17:00,1,331,13,11,356
8/4/16 18:00,5,292,16,16,329
8/4/16 19:00,1,301,20,5,327
8/4/16 20:00,1,205,11,7,224
8/4/16 21:00,0,150,13,4,167
8/4/16 22:00,0,136,6,3,145
8/4/16 23:00,0,74,7,6,87
9/4/16 0:00,0,56,7,6,69
9/4/16 1:00,0,29,5,3,37
9/4/16 2:00,1,30,4,2,37
9/4/16 3:00,0,29,7,3,39
9/4/16 4:00,0,22,4,1,27
9/4/16 5:00,0,24,6,1,31
9/4/16 6:00,0,66,3,4,73
9/4/16 7:00,2,108,7,3,120
9/4/16 8:00,1,231,15,2,249
9/4/16 9:00,1,233,17,7,258
9/4/16 10:00,9,276,16,5,306
9/4/16 11:00,4,290,15,8,317
9/4/16 12:00,8,311,14,16,349
9/4/16 13:00,3,281,20,13,317
9/4/16 14:00,5,358,16,17,396
9/4/16 15:00,9,396,21,16,442
9/4/16 16:00,5,440,18,6,469
9/4/16 17:00,2,515,25,25,567
9/4/16 18:00,3,487,27,23,540
9/4/16 19:00,5,460,29,9,503
9/4/16 20:00,2,415,31,3,451
9/4/16 21:00,0,290,14,8,312
9/4/16 22:00,1,169,16,8,194
9/4/16 23:00,0,106,21,9,136
10/4/16 0:00,1,71,13,9,94
10/4/16 1:00,0,41,10,4,55
10/4/16 2:00,0,22,10,3,35
10/4/16 3:00,1,22,5,2,30
10/4/16 4:00,0,22,9,3,34
10/4/16 5:00,0,48,9,14,71
10/4/16 6:00,0,130,13,18,161
10/4/16 7:00,0,201,16,14,231
10/4/16 8:00,0,286,11,15,312
10/4/16 9:00,0,292,18,23,333
10/4/16 10:00,1,270,21,17,309
10/4/16 11:00,0,232,24,21,277
10/4/16 12:00,0,216,12,27,255
10/4/16 13:00,3,222,18,34,277
10/4/16 14:00,4,228,9,21,262
10/4/16 15:00,2,262,16,20,300
10/4/16 16:00,1,257,19,25,302
10/4/16 17:00,0,234,13,26,273
10/4/16 18:00,0,227,21,16,264
10/4/16 19:00,0,153,13,13,179
10/4/16 20:00,0,148,6,9,163
10/4/16 21:00,1,123,11,12,147
10/4/16 22:00,0,89,10,17,116
10/4/16 23:00,1,65,3,13,82
11/4/16 0:00,0,54,7,7,68
11/4/16 1:00,0,30,11,7,48
11/4/16 2:00,0,28,4,8,40
11/4/16 3:00,0,23,3,6,32
11/4/16 4:00,0,7,12,7,26
11/4/16 5:00,0,47,12,8,67
11/4/16 6:00,0,78,14,12,104
11/4/16 7:00,0,174,22,14,210
11/4/16 8:00,1,235,11,13,260
11/4/16 9:00,0,260,19,22,301
11/4/16 10:00,1,237,13,23,274
11/4/16 11:00,1,213,20,40,274
11/4/16 12:00,0,196,16,17,229
11/4/16 13:00,2,202,18,25,247
11/4/16 14:00,1,207,14,31,253
11/4/16 15:00,0,201,18,12,231
11/4/16 16:00,1,234,21,15,271
11/4/16 17:00,2,199,12,17,230
11/4/16 18:00,5,193,12,20,230
11/4/16 19:00,0,164,10,16,190
11/4/16 20:00,1,151,11,22,185
11/4/16 21:00,0,122,14,27,163
11/4/16 22:00,2,100,12,24,138
11/4/16 23:00,0,53,11,8,72
12/4/16 0:00,0,46,12,13,71
12/4/16 1:00,0,24,6,0,30
12/4/16 2:00,0,25,8,8,41
12/4/16 3:00,0,23,7,5,35
12/4/16 4:00,0,21,7,8,36
12/4/16 5:00,0,32,14,13,59
12/4/16 6:00,0,74,18,18,110
12/4/16 7:00,0,161,14,16,191
12/4/16 8:00,0,218,12,9,239
12/4/16 9:00,2,245,24,21,292
12/4/16 10:00,3,247,24,21,295
12/4/16 11:00,1,208,18,19,246
12/4/16 12:00,0,221,20,21,262
12/4/16 13:00,3,224,25,32,284
12/4/16 14:00,1,256,10,37,304
12/4/16 15:00,2,277,11,22,312
12/4/16 16:00,0,274,26,24,324
12/4/16 17:00,0,245,21,28,294
12/4/16 18:00,0,233,18,12,263
12/4/16 19:00,0,209,17,12,238
12/4/16 20:00,2,147,9,13,171
12/4/16 21:00,2,123,14,19,158
12/4/16 22:00,0,102,18,15,135
12/4/16 23:00,0,66,8,13,87
13/4/16 0:00,0,50,12,15,77
13/4/16 1:00,1,33,8,2,44
13/4/16 2:00,0,21,5,6,32
13/4/16 3:00,0,10,5,6,21
13/4/16 4:00,0,23,12,9,44
13/4/16 5:00,0,28,13,14,55
13/4/16 6:00,0,73,17,23,113
13/4/16 7:00,0,152,30,10,192
13/4/16 8:00,0,231,29,12,272
13/4/16 9:00,0,288,25,14,327
13/4/16 10:00,3,259,32,23,317
13/4/16 11:00,3,266,15,24,308
13/4/16 12:00,0,237,24,24,285
13/4/16 13:00,1,257,28,36,322
13/4/16 14:00,4,252,22,28,306
13/4/16 15:00,0,306,28,35,369
13/4/16 16:00,1,276,18,15,310
13/4/16 17:00,1,250,26,31,308
13/4/16 18:00,1,274,15,19,309
13/4/16 19:00,1,215,20,12,248
13/4/16 20:00,0,162,8,15,185
13/4/16 21:00,1,116,13,13,143
13/4/16 22:00,0,106,10,19,135
13/4/16 23:00,0,70,7,13,90
14/4/16 0:00,0,48,4,8,60
14/4/16 1:00,0,34,11,7,52
14/4/16 2:00,0,14,5,5,24
14/4/16 3:00,0,22,6,7,35
14/4/16 4:00,0,26,10,8,44
14/4/16 5:00,0,29,5,4,38
14/4/16 6:00,0,68,15,14,97
14/4/16 7:00,0,139,27,8,174
14/4/16 8:00,0,218,13,16,247
14/4/16 9:00,3,241,22,13,279
14/4/16 10:00,2,277,27,23,329
14/4/16 11:00,4,285,29,23,341
14/4/16 12:00,2,301,21,24,348
14/4/16 13:00,2,317,18,31,368
14/4/16 14:00,1,368,22,42,433
14/4/16 15:00,4,371,17,26,418
14/4/16 16:00,9,407,16,21,453
14/4/16 17:00,5,460,18,16,499
14/4/16 18:00,0,367,28,21,416
14/4/16 19:00,0,280,17,8,305
14/4/16 20:00,0,247,14,11,272
14/4/16 21:00,0,171,13,6,190
14/4/16 22:00,1,118,8,12,139
14/4/16 23:00,0,93,14,2,109
15/4/16 0:00,1,60,5,16,82
15/4/16 1:00,0,34,8,3,45
15/4/16 2:00,0,21,4,4,29
15/4/16 3:00,0,25,9,0,34
15/4/16 4:00,0,36,10,1,47
15/4/16 5:00,0,59,6,7,72
15/4/16 6:00,1,92,8,5,106
15/4/16 7:00,4,151,15,10,180
15/4/16 8:00,2,222,18,7,249
15/4/16 9:00,5,259,23,5,292
15/4/16 10:00,1,325,19,21,366
15/4/16 11:00,3,346,21,13,383
15/4/16 12:00,3,316,11,17,347
15/4/16 13:00,2,286,15,16,319
15/4/16 14:00,1,272,12,17,302
15/4/16 15:00,4,287,16,11,318
15/4/16 16:00,5,307,19,17,348
15/4/16 17:00,9,309,17,14,349
15/4/16 18:00,2,305,18,6,331
15/4/16 19:00,4,320,15,5,344
15/4/16 20:00,5,213,7,6,231
15/4/16 21:00,1,180,10,7,198
15/4/16 22:00,1,129,7,0,137
15/4/16 23:00,0,75,9,6,90
16/4/16 0:00,0,58,6,1,65
16/4/16 1:00,0,35,1,3,39
16/4/16 2:00,0,29,2,3,34
16/4/16 3:00,0,36,8,2,46
16/4/16 4:00,0,14,9,1,24
16/4/16 5:00,0,24,4,1,29
16/4/16 6:00,0,63,7,2,72
16/4/16 7:00,1,117,10,1,129
16/4/16 8:00,1,164,12,5,182
16/4/16 9:00,6,213,13,7,239
16/4/16 10:00,13,256,19,10,298
16/4/16 11:00,8,265,16,14,303
16/4/16 12:00,7,324,19,12,362
16/4/16 13:00,6,373,15,22,416
16/4/16 14:00,6,418,16,17,457
16/4/16 15:00,10,361,15,14,400
16/4/16 16:00,15,410,24,28,477
16/4/16 17:00,6,442,23,21,492
16/4/16 18:00,6,448,22,15,491
16/4/16 19:00,4,402,16,11,433
16/4/16 20:00,11,340,23,12,386
16/4/16 21:00,6,236,19,7,268
16/4/16 22:00,1,271,20,6,298
16/4/16 23:00,1,110,21,10,142
17/4/16 0:00,0,81,13,7,101
17/4/16 1:00,0,40,7,5,52
17/4/16 2:00,0,15,8,5,28
17/4/16 3:00,0,29,5,5,39
17/4/16 4:00,0,20,12,6,38
17/4/16 5:00,0,58,8,5,71
17/4/16 6:00,0,123,16,10,149
17/4/16 7:00,0,250,15,15,280
17/4/16 8:00,1,239,7,12,259
17/4/16 9:00,2,307,17,18,344
17/4/16 10:00,1,240,22,22,285
17/4/16 11:00,0,261,13,28,302
17/4/16 12:00,2,244,14,29,289
17/4/16 13:00,1,215,14,20,250
17/4/16 14:00,2,273,11,31,317
17/4/16 15:00,4,230,13,19,266
17/4/16 16:00,1,215,14,15,245
17/4/16 17:00,0,237,26,30,293
17/4/16 18:00,3,255,15,12,285
17/4/16 19:00,0,202,12,14,228
17/4/16 20:00,1,164,12,15,192
17/4/16 21:00,0,139,10,5,154
17/4/16 22:00,0,106,8,13,127
17/4/16 23:00,0,83,8,15,106
18/4/16 0:00,0,43,10,5,58
18/4/16 1:00,0,41,9,9,59
18/4/16 2:00,0,30,4,5,39
18/4/16 3:00,0,20,4,4,28
18/4/16 4:00,0,20,7,6,33
18/4/16 5:00,0,40,15,7,62
18/4/16 6:00,1,87,13,21,122
18/4/16 7:00,0,169,14,13,196
18/4/16 8:00,1,238,19,12,270
18/4/16 9:00,0,278,21,22,321
18/4/16 10:00,0,254,15,24,293
18/4/16 11:00,1,206,22,40,269
18/4/16 12:00,2,214,20,22,258
18/4/16 13:00,1,203,20,32,256
18/4/16 14:00,2,252,17,21,292
18/4/16 15:00,0,228,22,27,277
18/4/16 16:00,0,251,20,32,303
18/4/16 17:00,2,249,19,19,289
18/4/16 18:00,1,220,21,17,259
18/4/16 19:00,0,229,12,15,256
18/4/16 20:00,0,149,14,16,179
18/4/16 21:00,0,116,18,13,147
18/4/16 22:00,1,97,12,12,122
18/4/16 23:00,0,54,7,7,68
19/4/16 0:00,0,39,10,8,57
19/4/16 1:00,0,32,5,5,42
19/4/16 2:00,0,15,9,4,28
19/4/16 3:00,0,18,5,7,30
19/4/16 4:00,0,18,8,8,34
19/4/16 5:00,0,34,12,15,61
19/4/16 6:00,1,90,19,14,124
19/4/16 7:00,0,175,10,22,207
19/4/16 8:00,0,256,9,14,279
19/4/16 9:00,0,331,19,15,365
19/4/16 10:00,2,246,30,27,305
19/4/16 11:00,1,269,21,24,315
19/4/16 12:00,2,225,16,32,275
19/4/16 13:00,1,232,16,28,277
19/4/16 14:00,6,268,15,22,311
19/4/16 15:00,2,314,19,22,357
19/4/16 16:00,2,305,20,25,352
19/4/16 17:00,2,266,26,17,311
19/4/16 18:00,3,300,18,12,333
19/4/16 19:00,5,263,23,11,302
19/4/16 20:00,3,192,12,3,210
19/4/16 21:00,0,141,15,17,173
19/4/16 22:00,0,113,13,24,150
19/4/16 23:00,0,60,11,11,82
20/4/16 0:00,0,53,11,12,76
20/4/16 1:00,0,31,6,12,49
20/4/16 2:00,0,22,9,4,35
20/4/16 3:00,0,23,6,5,34
20/4/16 4:00,0,15,10,4,29
20/4/16 5:00,0,29,11,12,52
20/4/16 6:00,1,77,13,13,104
20/4/16 7:00,0,160,23,13,196
20/4/16 8:00,1,269,19,11,300
20/4/16 9:00,1,295,33,17,346
20/4/16 10:00,1,321,21,22,365
20/4/16 11:00,1,239,21,33,294
20/4/16 12:00,1,273,27,31,332
20/4/16 13:00,2,310,29,31,372
20/4/16 14:00,3,291,22,37,353
20/4/16 15:00,2,345,19,30,396
20/4/16 16:00,2,328,24,21,375
20/4/16 17:00,2,362,19,14,397
20/4/16 18:00,0,308,21,24,353
20/4/16 19:00,0,282,29,17,328
20/4/16 20:00,0,215,20,10,245
20/4/16 21:00,0,167,19,14,200
20/4/16 22:00,1,151,9,10,171
20/4/16 23:00,0,65,10,17,92
21/4/16 0:00,1,46,11,11,69
21/4/16 1:00,0,40,10,5,55
21/4/16 2:00,0,37,10,2,49
21/4/16 3:00,0,21,5,4,30
21/4/16 4:00,0,19,12,5,36
21/4/16 5:00,0,43,12,9,64
21/4/16 6:00,2,81,10,20,113
21/4/16 7:00,0,177,18,13,208
21/4/16 8:00,0,234,17,7,258
21/4/16 9:00,3,279,20,16,318
21/4/16 10:00,3,280,27,20,330
21/4/16 11:00,1,357,25,27,410
21/4/16 12:00,5,337,20,30,392
21/4/16 13:00,5,350,23,26,404
21/4/16 14:00,2,424,16,25,467
21/4/16 15:00,2,472,26,26,526
21/4/16 16:00,3,504,24,18,549
21/4/16 17:00,1,488,30,23,542
21/4/16 18:00,3,475,27,16,521
21/4/16 19:00,1,348,17,12,378
21/4/16 20:00,1,267,20,9,297
21/4/16 21:00,0,200,21,8,229
21/4/16 22:00,1,159,14,4,178
21/4/16 23:00,0,99,8,9,116
22/4/16 0:00,0,75,9,6,90
22/4/16 1:00,0,34,6,4,44
22/4/16 2:00,0,39,9,5,53
22/4/16 3:00,0,26,7,2,35
22/4/16 4:00,0,30,7,3,40
22/4/16 5:00,0,96,8,4,108
22/4/16 6:00,2,120,21,6,149
22/4/16 7:00,1,165,15,4,185
22/4/16 8:00,1,241,24,6,272
22/4/16 9:00,3,326,27,10,366
22/4/16 10:00,2,417,13,21,453
22/4/16 11:00,12,448,22,7,489
22/4/16 12:00,0,377,19,14,410
22/4/16 13:00,6,371,13,11,401
22/4/16 14:00,2,355,10,25,392
22/4/16 15:00,4,365,13,20,402
22/4/16 16:00,6,360,17,6,389
22/4/16 17:00,3,319,17,14,353
22/4/16 18:00,7,287,16,5,315
22/4/16 19:00,4,362,16,7,389
22/4/16 20:00,0,251,17,11,279
22/4/16 21:00,0,166,25,8,199
22/4/16 22:00,0,148,11,7,166
22/4/16 23:00,0,65,7,7,79
23/4/16 0:00,0,49,7,4,60
23/4/16 1:00,0,40,5,3,48
23/4/16 2:00,0,29,6,2,37
23/4/16 3:00,0,25,6,3,34
23/4/16 4:00,0,27,10,0,37
23/4/16 5:00,0,31,14,3,48
23/4/16 6:00,0,58,6,8,72
23/4/16 7:00,0,99,11,7,117
23/4/16 8:00,1,152,12,4,169
23/4/16 9:00,2,230,14,12,258
23/4/16 10:00,14,312,21,9,356
23/4/16 11:00,3,369,23,11,406
23/4/16 12:00,10,350,18,27,405
23/4/16 13:00,4,357,18,17,396
23/4/16 14:00,1,359,19,10,389
23/4/16 15:00,20,392,23,12,447
23/4/16 16:00,0,377,22,11,410
23/4/16 17:00,5,392,26,25,448
23/4/16 18:00,6,384,16,24,430
23/4/16 19:00,4,386,15,17,422
23/4/16 20:00,1,313,20,10,344
23/4/16 21:00,1,254,18,9,282
23/4/16 22:00,1,136,18,14,169
23/4/16 23:00,0,93,12,12,117
24/4/16 0:00,0,79,17,8,104
24/4/16 1:00,0,42,7,4,53
24/4/16 2:00,0,23,10,4,37
24/4/16 3:00,0,24,6,7,37
24/4/16 4:00,0,22,11,1,34
24/4/16 5:00,0,41,8,5,54
24/4/16 6:00,0,120,16,14,150
24/4/16 7:00,1,195,17,16,229
24/4/16 8:00,0,247,10,8,265
24/4/16 9:00,0,317,17,13,347
24/4/16 10:00,2,301,21,25,349
24/4/16 11:00,2,278,16,25,321
24/4/16 12:00,3,289,21,23,336
24/4/16 13:00,3,277,22,24,326
24/4/16 14:00,2,288,16,21,327
24/4/16 15:00,2,312,16,23,353
24/4/16 16:00,3,294,22,18,337
24/4/16 17:00,2,292,13,16,323
24/4/16 18:00,3,273,10,23,309
24/4/16 19:00,4,232,16,20,272
24/4/16 20:00,3,173,8,15,199
24/4/16 21:00,2,145,19,3,169
24/4/16 22:00,0,86,10,10,106
24/4/16 23:00,0,65,10,2,77
25/4/16 0:00,0,48,26,7,81
25/4/16 1:00,1,47,9,3,60
25/4/16 2:00,0,29,6,4,39
25/4/16 3:00,0,21,8,7,36
25/4/16 4:00,0,20,9,8,37
25/4/16 5:00,0,25,6,13,44
25/4/16 6:00,0,59,18,24,101
25/4/16 7:00,0,161,23,21,205
25/4/16 8:00,0,205,20,14,239
25/4/16 9:00,1,245,15,22,283
25/4/16 10:00,0,298,9,24,331
25/4/16 11:00,0,281,21,22,324
25/4/16 12:00,1,292,19,21,333
25/4/16 13:00,4,291,22,28,345
25/4/16 14:00,0,270,17,22,309
25/4/16 15:00,2,323,20,24,369
25/4/16 16:00,3,315,30,22,370
25/4/16 17:00,1,302,20,19,342
25/4/16 18:00,0,293,11,14,318
25/4/16 19:00,1,285,16,23,325
25/4/16 20:00,1,190,12,17,220
25/4/16 21:00,0,163,23,15,201
25/4/16 22:00,0,142,14,13,169
25/4/16 23:00,0,82,7,13,102
26/4/16 0:00,0,37,6,15,58
26/4/16 1:00,0,40,9,7,56
26/4/16 2:00,0,21,7,3,31
26/4/16 3:00,0,25,5,10,40
26/4/16 4:00,0,18,8,6,32
26/4/16 5:00,0,46,19,7,72
26/4/16 6:00,0,89,14,17,120
26/4/16 7:00,0,138,16,17,171
26/4/16 8:00,1,214,21,10,246
26/4/16 9:00,1,298,16,18,333
26/4/16 10:00,1,270,16,15,302
26/4/16 11:00,0,333,17,38,388
26/4/16 12:00,4,360,20,23,407
26/4/16 13:00,0,335,19,25,379
26/4/16 14:00,1,341,20,28,390
26/4/16 15:00,3,373,15,26,417
26/4/16 16:00,1,413,17,19,450
26/4/16 17:00,1,371,20,18,410
26/4/16 18:00,6,336,16,16,374
26/4/16 19:00,1,282,13,11,307
26/4/16 20:00,1,223,11,17,252
26/4/16 21:00,1,212,13,11,237
26/4/16 22:00,0,137,6,14,157
26/4/16 23:00,1,100,20,19,140
27/4/16 0:00,0,67,10,13,90
27/4/16 1:00,0,60,5,11,76
27/4/16 2:00,0,42,5,6,53
27/4/16 3:00,0,31,4,10,45
27/4/16 4:00,0,31,11,12,54
27/4/16 5:00,0,47,9,10,66
27/4/16 6:00,0,77,14,12,103
27/4/16 7:00,0,123,21,14,158
27/4/16 8:00,1,190,11,10,212
27/4/16 9:00,0,268,15,7,290
27/4/16 10:00,5,357,14,29,405
27/4/16 11:00,6,437,14,23,480
27/4/16 12:00,4,469,20,23,516
27/4/16 13:00,3,535,17,30,585
27/4/16 14:00,3,514,21,21,559
27/4/16 15:00,3,534,11,19,567
27/4/16 16:00,2,501,24,22,549
27/4/16 17:00,1,531,19,17,568
27/4/16 18:00,6,514,17,20,557
27/4/16 19:00,5,413,12,7,437
27/4/16 20:00,0,302,8,6,316
27/4/16 21:00,1,212,12,11,236
27/4/16 22:00,0,177,7,3,187
27/4/16 23:00,1,113,7,10,131
28/4/16 0:00,0,92,10,4,106
28/4/16 1:00,0,74,6,5,85
28/4/16 2:00,0,44,7,8,59
28/4/16 3:00,0,46,7,2,55
28/4/16 4:00,0,31,10,3,44
28/4/16 5:00,0,58,8,4,70
28/4/16 6:00,1,89,11,4,105
28/4/16 7:00,0,151,9,3,163
28/4/16 8:00,0,221,12,2,235
28/4/16 9:00,0,377,21,9,407
28/4/16 10:00,1,532,11,3,547
28/4/16 11:00,2,669,22,16,709
28/4/16 12:00,4,778,14,12,808
28/4/16 13:00,1,670,11,12,694
28/4/16 14:00,2,540,10,12,564
28/4/16 15:00,3,462,11,10,486
28/4/16 16:00,0,437,11,4,452
28/4/16 17:00,4,471,13,4,492
28/4/16 18:00,1,329,15,5,350
28/4/16 19:00,1,233,6,3,243
28/4/16 20:00,0,192,4,4,200
28/4/16 21:00,2,108,6,2,118
28/4/16 22:00,6,76,5,3,90
28/4/16 23:00,0,67,2,2,71
29/4/16 0:00,0,51,9,6,66
29/4/16 1:00,0,40,3,2,45
29/4/16 2:00,0,23,5,1,29
29/4/16 3:00,1,16,4,3,24
29/4/16 4:00,0,18,3,0,21
29/4/16 5:00,0,35,4,2,41
29/4/16 6:00,1,61,7,1,70
29/4/16 7:00,0,82,11,4,97
29/4/16 8:00,1,115,10,7,133
29/4/16 9:00,2,219,8,9,238
29/4/16 10:00,4,346,9,11,370
29/4/16 11:00,5,467,9,13,494
29/4/16 12:00,2,474,4,13,493
29/4/16 13:00,4,422,11,6,443
29/4/16 14:00,2,390,6,10,408
29/4/16 15:00,1,395,6,9,411
29/4/16 16:00,0,423,10,6,439
29/4/16 17:00,3,408,8,17,436
29/4/16 18:00,2,380,9,5,396
29/4/16 19:00,5,338,5,1,349
29/4/16 20:00,0,208,5,4,217
29/4/16 21:00,1,125,3,1,130
29/4/16 22:00,0,94,4,3,101
29/4/16 23:00,0,53,4,0,57
30/4/16 0:00,0,39,3,0,42
30/4/16 1:00,0,43,2,0,45
30/4/16 2:00,0,20,2,0,22
30/4/16 3:00,0,19,2,0,21
30/4/16 4:00,0,14,2,0,16
30/4/16 5:00,0,24,2,0,26
30/4/16 6:00,1,59,1,1,62
30/4/16 7:00,0,77,2,1,80
30/4/16 8:00,0,117,4,3,124
30/4/16 9:00,7,245,1,2,255
30/4/16 10:00,0,320,11,9,340
30/4/16 11:00,5,400,9,7,421
30/4/16 12:00,1,310,3,9,323
30/4/16 13:00,1,243,2,11,257
30/4/16 14:00,2,158,3,8,171
30/4/16 15:00,2,158,1,11,172
30/4/16 16:00,0,200,6,13,219
30/4/16 17:00,9,274,2,14,299
30/4/16 18:00,1,371,4,4,380
30/4/16 19:00,5,304,0,1,310
30/4/16 20:00,3,259,2,6,270
30/4/16 21:00,0,175,4,2,181
30/4/16 22:00,0,123,6,2,131
30/4/16 23:00,0,74,3,0,77
1/5/16 0:00,0,47,4,1,52
1/5/16 1:00,0,36,3,2,41
1/5/16 2:00,0,13,2,3,18
1/5/16 3:00,0,26,2,1,29
1/5/16 4:00,0,21,3,1,25
1/5/16 5:00,0,18,2,0,20
1/5/16 6:00,0,47,2,1,50
1/5/16 7:00,0,99,0,1,100
1/5/16 8:00,0,166,7,4,177
1/5/16 9:00,3,323,3,5,334
1/5/16 10:00,6,492,13,6,517
1/5/16 11:00,1,676,9,12,698
1/5/16 12:00,10,728,8,17,763
1/5/16 13:00,1,690,5,15,711
1/5/16 14:00,3,630,3,7,643
1/5/16 15:00,5,669,8,11,693
1/5/16 16:00,6,627,12,6,651
1/5/16 17:00,2,724,5,2,733
1/5/16 18:00,2,654,12,11,679
1/5/16 19:00,0,593,12,2,607
1/5/16 20:00,0,382,6,3,391
1/5/16 21:00,0,277,7,3,287
1/5/16 22:00,0,207,9,3,219
1/5/16 23:00,0,104,7,4,115
2/5/16 0:00,0,73,11,2,86
2/5/16 1:00,0,42,6,1,49
2/5/16 2:00,1,53,4,1,59
2/5/16 3:00,0,30,4,5,39
2/5/16 4:00,0,27,3,5,35
2/5/16 5:00,1,46,4,2,53
2/5/16 6:00,0,58,9,4,71
2/5/16 7:00,0,90,10,2,102
2/5/16 8:00,3,155,7,5,170
2/5/16 9:00,1,269,13,8,291
2/5/16 10:00,2,450,12,6,470
2/5/16 11:00,7,674,11,9,701
2/5/16 12:00,4,791,16,8,819
2/5/16 13:00,3,901,13,11,928
2/5/16 14:00,5,814,16,13,848
2/5/16 15:00,1,793,17,6,817
2/5/16 16:00,1,870,14,15,900
2/5/16 17:00,0,894,16,5,915
2/5/16 18:00,1,839,22,9,871
2/5/16 19:00,2,675,7,9,693
2/5/16 20:00,3,520,10,6,539
2/5/16 21:00,6,293,15,10,324
2/5/16 22:00,0,223,9,3,235
2/5/16 23:00,0,113,8,8,129
3/5/16 0:00,0,75,9,3,87
3/5/16 1:00,0,53,11,10,74
3/5/16 2:00,0,35,4,3,42
3/5/16 3:00,0,30,4,3,37
3/5/16 4:00,0,28,9,6,43
3/5/16 5:00,0,58,14,3,75
3/5/16 6:00,1,135,16,4,156
3/5/16 7:00,0,194,12,10,216
3/5/16 8:00,0,239,13,8,260
3/5/16 9:00,3,301,16,14,334
3/5/16 10:00,1,394,22,17,434
3/5/16 11:00,8,472,18,20,518
3/5/16 12:00,4,497,17,19,537
3/5/16 13:00,2,459,18,24,503
3/5/16 14:00,0,457,23,33,513
3/5/16 15:00,1,421,22,14,458
3/5/16 16:00,1,445,19,10,475
3/5/16 17:00,3,476,13,20,512
3/5/16 18:00,2,418,14,10,444
3/5/16 19:00,5,416,18,14,453
3/5/16 20:00,5,374,14,15,408
3/5/16 21:00,0,188,11,17,216
3/5/16 22:00,0,138,14,7,159
3/5/16 23:00,0,86,11,8,105
4/5/16 0:00,0,57,17,7,81
4/5/16 1:00,0,35,7,6,48
4/5/16 2:00,0,18,9,11,38
4/5/16 3:00,0,27,5,7,39
4/5/16 4:00,0,25,10,10,45
4/5/16 5:00,0,36,14,10,60
4/5/16 6:00,0,98,16,16,130
4/5/16 7:00,0,172,14,9,195
4/5/16 8:00,1,251,20,7,279
4/5/16 9:00,0,332,19,10,361
4/5/16 10:00,6,339,20,17,382
4/5/16 11:00,5,433,20,32,490
4/5/16 12:00,3,395,22,22,442
4/5/16 13:00,7,431,21,36,495
4/5/16 14:00,4,357,18,21,400
4/5/16 15:00,1,376,18,27,422
4/5/16 16:00,8,355,16,21,400
4/5/16 17:00,3,339,19,29,390
4/5/16 18:00,3,314,14,18,349
4/5/16 19:00,6,217,16,12,251
4/5/16 20:00,0,200,10,18,228
4/5/16 21:00,0,149,13,10,172
4/5/16 22:00,0,114,10,18,142
4/5/16 23:00,0,71,9,10,90
5/5/16 0:00,0,57,13,10,80
5/5/16 1:00,0,55,10,10,75
5/5/16 2:00,0,21,9,6,36
5/5/16 3:00,0,38,4,5,47
5/5/16 4:00,0,17,9,7,33
5/5/16 5:00,0,37,5,9,51
5/5/16 6:00,0,84,12,14,110
5/5/16 7:00,0,156,19,22,197
5/5/16 8:00,0,204,20,12,236
5/5/16 9:00,0,275,21,14,310
5/5/16 10:00,0,341,21,17,379
5/5/16 11:00,5,361,22,19,407
5/5/16 12:00,1,375,19,32,427
5/5/16 13:00,1,385,14,28,428
5/5/16 14:00,8,369,18,27,422
5/5/16 15:00,5,391,16,28,440
5/5/16 16:00,3,487,14,21,525
5/5/16 17:00,0,437,15,10,462
5/5/16 18:00,3,417,15,19,454
5/5/16 19:00,1,315,17,10,343
5/5/16 20:00,0,262,12,8,282
5/5/16 21:00,1,213,16,10,240
5/5/16 22:00,1,132,11,8,152
5/5/16 23:00,2,89,7,4,102
6/5/16 0:00,0,64,5,10,79
6/5/16 1:00,0,49,10,4,63
6/5/16 2:00,0,32,7,5,44
6/5/16 3:00,0,26,4,1,31
6/5/16 4:00,0,31,3,2,36
6/5/16 5:00,0,42,12,5,59
6/5/16 6:00,0,66,10,4,80
6/5/16 7:00,0,138,16,7,161
6/5/16 8:00,0,237,15,8,260
6/5/16 9:00,1,314,18,15,348
6/5/16 10:00,4,400,11,11,426
6/5/16 11:00,1,424,16,9,450
6/5/16 12:00,3,473,10,7,493
6/5/16 13:00,9,424,14,12,459
6/5/16 14:00,2,398,14,7,421
6/5/16 15:00,10,393,15,12,430
6/5/16 16:00,3,436,13,10,462
6/5/16 17:00,5,486,21,8,520
6/5/16 18:00,2,393,14,7,416
6/5/16 19:00,2,342,8,1,353
6/5/16 20:00,4,295,12,13,324
6/5/16 21:00,0,248,13,15,276
6/5/16 22:00,0,187,12,3,202
6/5/16 23:00,0,126,8,3,137
7/5/16 0:00,0,91,8,2,101
7/5/16 1:00,0,47,6,3,56
7/5/16 2:00,1,31,3,0,35
7/5/16 3:00,0,42,3,3,48
7/5/16 4:00,0,35,9,1,45
7/5/16 5:00,0,26,3,1,30
7/5/16 6:00,0,66,3,1,70
7/5/16 7:00,0,85,4,1,90
7/5/16 8:00,5,166,9,2,182
7/5/16 9:00,1,304,14,2,321
7/5/16 10:00,4,373,18,1,396
7/5/16 11:00,4,454,20,5,483
7/5/16 12:00,5,494,16,11,526
7/5/16 13:00,4,440,17,9,470
7/5/16 14:00,1,477,14,13,505
7/5/16 15:00,4,498,22,9,533
7/5/16 16:00,22,636,17,9,684
7/5/16 17:00,13,696,23,11,743
7/5/16 18:00,3,622,29,12,666
7/5/16 19:00,4,578,10,16,608
7/5/16 20:00,1,492,18,1,512
7/5/16 21:00,2,320,22,12,356
7/5/16 22:00,2,215,20,13,250
7/5/16 23:00,1,146,11,16,174
8/5/16 0:00,0,98,14,5,117
8/5/16 1:00,0,64,15,10,89
8/5/16 2:00,0,34,7,8,49
8/5/16 3:00,0,26,6,3,35
8/5/16 4:00,0,32,13,2,47
8/5/16 5:00,0,57,8,9,74
8/5/16 6:00,0,118,12,6,136
8/5/16 7:00,0,231,10,15,256
8/5/16 8:00,1,259,12,9,281
8/5/16 9:00,5,304,17,10,336
8/5/16 10:00,2,320,14,27,363
8/5/16 11:00,4,326,18,23,371
8/5/16 12:00,0,323,22,27,372
8/5/16 13:00,3,295,18,23,339
8/5/16 14:00,3,247,14,12,276
8/5/16 15:00,6,309,14,28,357
8/5/16 16:00,1,265,17,16,299
8/5/16 17:00,3,272,12,10,297
8/5/16 18:00,1,251,16,12,280
8/5/16 19:00,1,222,17,13,253
8/5/16 20:00,0,179,3,9,191
8/5/16 21:00,1,144,13,13,171
8/5/16 22:00,1,148,11,13,173
8/5/16 23:00,0,73,16,7,96
9/5/16 0:00,0,46,10,11,67
9/5/16 1:00,0,45,7,7,59
9/5/16 2:00,0,43,5,6,54
9/5/16 3:00,0,27,10,7,44
9/5/16 4:00,0,24,9,7,40
9/5/16 5:00,0,52,7,12,71
9/5/16 6:00,0,80,22,15,117
9/5/16 7:00,1,198,19,6,224
9/5/16 8:00,0,250,16,11,277
9/5/16 9:00,1,240,16,17,274
9/5/16 10:00,0,274,22,21,317
9/5/16 11:00,2,267,20,23,312
9/5/16 12:00,2,264,29,19,314
9/5/16 13:00,1,222,18,32,273
9/5/16 14:00,0,252,19,15,286
9/5/16 15:00,4,270,12,15,301
9/5/16 16:00,2,268,20,19,309
9/5/16 17:00,1,254,14,21,290
9/5/16 18:00,2,265,15,12,294
9/5/16 19:00,1,243,12,14,270
9/5/16 20:00,1,217,11,9,238
9/5/16 21:00,0,158,18,11,187
9/5/16 22:00,0,105,9,21,135
9/5/16 23:00,0,82,6,11,99
10/5/16 0:00,0,50,10,9,69
10/5/16 1:00,0,32,9,3,44
10/5/16 2:00,0,35,11,3,49
10/5/16 3:00,0,15,5,5,25
10/5/16 4:00,0,20,18,4,42
10/5/16 5:00,0,40,11,11,62
10/5/16 6:00,0,84,20,13,117
10/5/16 7:00,1,161,17,15,194
10/5/16 8:00,0,225,15,18,258
10/5/16 9:00,2,277,16,20,315
10/5/16 10:00,1,266,21,18,306
10/5/16 11:00,1,265,26,30,322
10/5/16 12:00,9,219,19,26,273
10/5/16 13:00,2,265,21,34,322
10/5/16 14:00,3,249,24,15,291
10/5/16 15:00,0,317,21,22,360
10/5/16 16:00,7,320,24,20,371
10/5/16 17:00,1,265,14,27,307
10/5/16 18:00,3,265,19,16,303
10/5/16 19:00,2,208,13,25,248
10/5/16 20:00,8,192,9,15,224
10/5/16 21:00,1,180,14,10,205
10/5/16 22:00,2,126,17,6,151
10/5/16 23:00,0,81,8,13,102
11/5/16 0:00,3,125,14,15,157
11/5/16 1:00,0,49,11,8,68
11/5/16 2:00,0,32,9,6,47
11/5/16 3:00,0,34,8,12,54
11/5/16 4:00,0,17,13,9,39
11/5/16 5:00,0,37,15,11,63
11/5/16 6:00,0,92,13,13,118
11/5/16 7:00,0,183,23,16,222
11/5/16 8:00,0,223,22,7,252
11/5/16 9:00,5,298,24,15,342
11/5/16 10:00,1,275,16,25,317
11/5/16 11:00,2,273,18,31,324
11/5/16 12:00,4,242,16,23,285
11/5/16 13:00,4,283,26,22,335
11/5/16 14:00,2,301,22,26,351
11/5/16 15:00,4,326,25,26,381
11/5/16 16:00,1,335,24,17,377
11/5/16 17:00,1,294,16,29,340
11/5/16 18:00,1,259,12,19,291
11/5/16 19:00,1,211,16,23,251
11/5/16 20:00,1,180,11,8,200
11/5/16 21:00,8,157,11,12,188
11/5/16 22:00,0,117,15,12,144
11/5/16 23:00,0,70,10,18,98
12/5/16 0:00,0,55,15,6,76
12/5/16 1:00,0,48,6,4,58
12/5/16 2:00,0,24,8,7,39
12/5/16 3:00,0,26,4,5,35
12/5/16 4:00,0,21,10,11,42
12/5/16 5:00,0,48,9,3,60
12/5/16 6:00,0,73,15,12,100
12/5/16 7:00,0,131,15,16,162
12/5/16 8:00,1,189,22,13,225
12/5/16 9:00,1,233,16,15,265
12/5/16 10:00,6,291,19,23,339
12/5/16 11:00,2,295,25,28,350
12/5/16 12:00,4,314,11,31,360
12/5/16 13:00,13,337,20,25,395
12/5/16 14:00,6,375,20,30,431
12/5/16 15:00,2,387,15,17,421
12/5/16 16:00,1,434,24,38,497
12/5/16 17:00,6,423,14,17,460
12/5/16 18:00,1,419,19,26,465
12/5/16 19:00,6,305,17,11,339
12/5/16 20:00,3,230,14,4,251
12/5/16 21:00,2,210,19,7,238
12/5/16 22:00,0,134,8,2,144
12/5/16 23:00,2,101,8,6,117
13/5/16 0:00,0,67,9,6,82
13/5/16 1:00,0,54,11,7,72
13/5/16 2:00,0,44,4,3,51
13/5/16 3:00,0,38,4,2,44
13/5/16 4:00,0,28,9,1,38
13/5/16 5:00,0,58,7,4,69
13/5/16 6:00,1,81,9,5,96
13/5/16 7:00,3,140,15,6,164
13/5/16 8:00,1,215,10,10,236
13/5/16 9:00,1,323,17,7,348
13/5/16 10:00,1,344,22,6,373
13/5/16 11:00,3,329,15,9,356
13/5/16 12:00,0,298,13,9,320
13/5/16 13:00,5,292,9,21,327
13/5/16 14:00,10,324,10,12,356
13/5/16 15:00,1,339,10,15,365
13/5/16 16:00,2,299,11,11,323
13/5/16 17:00,2,358,12,10,382
13/5/16 18:00,5,318,12,7,342
13/5/16 19:00,4,296,12,10,322
13/5/16 20:00,0,220,7,2,229
13/5/16 21:00,1,173,13,7,194
13/5/16 22:00,4,143,5,4,156
13/5/16 23:00,2,105,8,4,119
14/5/16 0:00,0,63,7,5,75
14/5/16 1:00,0,67,4,6,77
14/5/16 2:00,1,25,5,3,34
14/5/16 3:00,0,29,9,4,42
14/5/16 4:00,0,33,3,1,37
14/5/16 5:00,0,31,7,0,38
14/5/16 6:00,0,64,4,2,70
14/5/16 7:00,0,137,2,2,141
14/5/16 8:00,2,211,16,10,239
14/5/16 9:00,2,205,14,5,226
14/5/16 10:00,7,302,14,9,332
14/5/16 11:00,6,343,14,7,370
14/5/16 12:00,4,373,12,17,406
14/5/16 13:00,3,352,14,12,381
14/5/16 14:00,6,370,15,14,405
14/5/16 15:00,5,382,16,14,417
14/5/16 16:00,6,491,15,11,523
14/5/16 17:00,5,510,17,6,538
14/5/16 18:00,20,520,19,21,580
14/5/16 19:00,9,473,22,14,518
14/5/16 20:00,2,382,8,13,405
14/5/16 21:00,0,279,17,13,309
14/5/16 22:00,2,198,16,12,228
14/5/16 23:00,2,133,16,10,161
15/5/16 0:00,0,82,10,10,102
15/5/16 1:00,0,75,8,3,86
15/5/16 2:00,0,33,4,3,40
15/5/16 3:00,0,29,6,7,42
15/5/16 4:00,0,24,6,6,36
15/5/16 5:00,0,62,10,10,82
15/5/16 6:00,0,138,11,14,163
15/5/16 7:00,1,213,15,11,240
15/5/16 8:00,1,272,13,15,301
15/5/16 9:00,2,288,15,10,315
15/5/16 10:00,2,269,21,34,326
15/5/16 11:00,1,249,23,25,298
15/5/16 12:00,1,251,13,24,289
15/5/16 13:00,1,229,11,21,262
15/5/16 14:00,1,208,17,20,246
15/5/16 15:00,1,262,19,24,306
15/5/16 16:00,2,235,8,27,272
15/5/16 17:00,1,228,14,22,265
15/5/16 18:00,2,243,17,15,277
15/5/16 19:00,2,210,11,15,238
15/5/16 20:00,0,160,5,14,179
15/5/16 21:00,0,145,18,9,172
15/5/16 22:00,1,94,11,16,122
15/5/16 23:00,0,66,8,8,82
16/5/16 0:00,0,62,9,13,84
16/5/16 1:00,0,44,10,10,64
16/5/16 2:00,0,31,4,6,41
16/5/16 3:00,0,30,8,4,42
16/5/16 4:00,0,23,17,4,44
16/5/16 5:00,0,45,12,12,69
16/5/16 6:00,0,96,10,21,127
16/5/16 7:00,0,196,27,12,235
16/5/16 8:00,0,252,10,18,280
16/5/16 9:00,1,250,14,11,276
16/5/16 10:00,3,245,16,15,279
16/5/16 11:00,0,206,22,29,257
16/5/16 12:00,2,201,17,29,249
16/5/16 13:00,1,224,17,37,279
16/5/16 14:00,1,233,17,23,274
16/5/16 15:00,3,227,19,19,268
16/5/16 16:00,0,237,21,12,270
16/5/16 17:00,2,222,13,17,254
16/5/16 18:00,1,199,13,15,228
16/5/16 19:00,0,180,17,14,211
16/5/16 20:00,0,159,6,12,177
16/5/16 21:00,3,119,14,16,152
16/5/16 22:00,1,105,10,19,135
16/5/16 23:00,0,78,7,14,99
17/5/16 0:00,0,61,13,10,84
17/5/16 1:00,0,32,6,4,42
17/5/16 2:00,0,21,8,6,35
17/5/16 3:00,0,24,5,5,34
17/5/16 4:00,0,30,9,5,44
17/5/16 5:00,0,27,11,9,47
17/5/16 6:00,0,78,14,22,114
17/5/16 7:00,0,166,26,14,206
17/5/16 8:00,0,240,14,9,263
17/5/16 9:00,0,251,11,16,278
17/5/16 10:00,9,251,15,17,292
17/5/16 11:00,0,223,15,27,265
17/5/16 12:00,2,209,18,25,254
17/5/16 13:00,2,241,16,23,282
17/5/16 14:00,2,247,14,26,289
17/5/16 15:00,3,295,16,18,332
17/5/16 16:00,4,264,14,19,301
17/5/16 17:00,10,273,14,15,312
17/5/16 18:00,6,258,13,17,294
17/5/16 19:00,5,253,21,11,290
17/5/16 20:00,3,175,9,24,211
17/5/16 21:00,1,125,17,16,159
17/5/16 22:00,0,100,12,17,129
17/5/16 23:00,0,65,12,7,84
18/5/16 0:00,3,43,5,11,62
18/5/16 1:00,0,41,10,6,57
18/5/16 2:00,0,18,10,9,37
18/5/16 3:00,0,22,8,4,34
18/5/16 4:00,0,28,10,14,52
18/5/16 5:00,0,41,13,8,62
18/5/16 6:00,0,85,18,17,120
18/5/16 7:00,2,192,38,8,240
18/5/16 8:00,2,233,31,19,285
18/5/16 9:00,3,290,22,21,336
18/5/16 10:00,2,314,23,23,362
18/5/16 11:00,15,278,23,26,342
18/5/16 12:00,8,263,28,40,339
18/5/16 13:00,4,267,31,26,328
18/5/16 14:00,7,306,21,23,357
18/5/16 15:00,13,332,20,24,389
18/5/16 16:00,11,318,22,24,375
18/5/16 17:00,7,290,18,19,334
18/5/16 18:00,14,297,13,16,340
18/5/16 19:00,4,247,20,18,289
18/5/16 20:00,1,212,4,7,224
18/5/16 21:00,1,150,20,14,185
18/5/16 22:00,2,134,14,18,168
18/5/16 23:00,0,66,7,13,86
19/5/16 0:00,0,45,6,7,58
19/5/16 1:00,0,32,6,7,45
19/5/16 2:00,0,26,11,10,47
19/5/16 3:00,0,27,8,4,39
19/5/16 4:00,0,19,11,8,38
19/5/16 5:00,0,32,14,11,57
19/5/16 6:00,0,85,18,21,124
19/5/16 7:00,0,156,24,14,194
19/5/16 8:00,3,202,14,8,227
19/5/16 9:00,1,246,24,15,286
19/5/16 10:00,2,306,25,38,371
19/5/16 11:00,8,292,27,21,348
19/5/16 12:00,2,313,20,33,368
19/5/16 13:00,12,352,15,27,406
19/5/16 14:00,11,341,21,27,400
19/5/16 15:00,3,443,20,21,487
19/5/16 16:00,1,466,17,17,501
19/5/16 17:00,4,437,20,14,475
19/5/16 18:00,0,396,16,17,429
19/5/16 19:00,3,313,24,12,352
19/5/16 20:00,2,255,12,5,274
19/5/16 21:00,0,194,16,5,215
19/5/16 22:00,1,152,8,6,167
19/5/16 23:00,0,83,9,7,99
20/5/16 0:00,0,69,5,3,77
20/5/16 1:00,0,45,11,1,57
20/5/16 2:00,0,29,9,4,42
20/5/16 3:00,0,33,5,3,41
20/5/16 4:00,0,22,5,4,31
20/5/16 5:00,0,48,8,6,62
20/5/16 6:00,0,74,9,6,89
20/5/16 7:00,1,127,15,7,150
20/5/16 8:00,0,167,7,6,180
20/5/16 9:00,0,271,15,10,296
20/5/16 10:00,0,354,24,10,388
20/5/16 11:00,6,395,16,10,427
20/5/16 12:00,0,409,23,11,443
20/5/16 13:00,2,376,15,12,405
20/5/16 14:00,14,343,10,7,374
20/5/16 15:00,7,346,10,4,367
20/5/16 16:00,14,334,16,13,377
20/5/16 17:00,6,355,20,7,388
20/5/16 18:00,2,321,24,4,351
20/5/16 19:00,2,259,12,5,278
20/5/16 20:00,3,254,8,5,270
20/5/16 21:00,0,119,13,7,139
20/5/16 22:00,0,106,5,7,118
20/5/16 23:00,0,75,6,2,83
21/5/16 0:00,0,64,8,4,76
21/5/16 1:00,0,61,7,2,70
21/5/16 2:00,0,26,7,2,35
21/5/16 3:00,0,34,5,3,42
21/5/16 4:00,0,29,6,1,36
21/5/16 5:00,0,39,9,3,51
21/5/16 6:00,0,65,4,3,72
21/5/16 7:00,0,96,4,4,104
21/5/16 8:00,0,143,12,3,158
21/5/16 9:00,2,174,16,1,193
21/5/16 10:00,6,274,20,3,303
21/5/16 11:00,3,362,15,2,382
21/5/16 12:00,5,368,15,3,391
21/5/16 13:00,16,349,22,8,395
21/5/16 14:00,5,385,17,7,414
21/5/16 15:00,5,396,16,2,419
21/5/16 16:00,5,412,15,5,437
21/5/16 17:00,0,468,22,7,497
21/5/16 18:00,8,479,16,13,516
21/5/16 19:00,1,409,12,12,434
21/5/16 20:00,5,324,16,8,353
21/5/16 21:00,0,286,14,10,310
21/5/16 22:00,0,182,6,7,195
21/5/16 23:00,0,99,11,9,119
22/5/16 0:00,0,61,9,4,74
22/5/16 1:00,0,63,12,4,79
22/5/16 2:00,0,29,5,11,45
22/5/16 3:00,0,31,6,14,51
22/5/16 4:00,0,22,9,5,36
22/5/16 5:00,0,57,5,8,70
22/5/16 6:00,0,131,10,14,155
22/5/16 7:00,0,212,19,7,238
22/5/16 8:00,1,240,10,11,262
22/5/16 9:00,1,276,14,11,302
22/5/16 10:00,4,242,19,20,285
22/5/16 11:00,2,258,17,28,305
22/5/16 12:00,2,263,9,23,297
22/5/16 13:00,5,275,12,22,314
22/5/16 14:00,3,251,14,25,293
22/5/16 15:00,1,254,15,21,291
22/5/16 16:00,6,253,16,20,295
22/5/16 17:00,2,253,12,23,290
22/5/16 18:00,3,223,16,10,252
22/5/16 19:00,2,220,12,24,258
22/5/16 20:00,1,197,5,11,214
22/5/16 21:00,0,155,11,13,179
22/5/16 22:00,0,90,10,13,113
22/5/16 23:00,0,70,9,13,92
23/5/16 0:00,1,54,13,6,74
23/5/16 1:00,0,42,6,5,53
23/5/16 2:00,0,22,5,5,32
23/5/16 3:00,0,20,9,4,33
23/5/16 4:00,0,24,9,6,39
23/5/16 5:00,0,56,14,12,82
23/5/16 6:00,0,92,20,23,135
23/5/16 7:00,0,176,18,17,211
23/5/16 8:00,1,238,16,12,267
23/5/16 9:00,5,286,20,13,324
23/5/16 10:00,0,245,19,25,289
23/5/16 11:00,2,253,18,30,303
23/5/16 12:00,2,265,10,26,303
23/5/16 13:00,7,315,19,29,370
23/5/16 14:00,1,282,21,29,333
23/5/16 15:00,4,303,19,24,350
23/5/16 16:00,1,271,22,28,322
23/5/16 17:00,4,256,17,16,293
23/5/16 18:00,3,279,18,15,315
23/5/16 19:00,1,205,12,23,241
23/5/16 20:00,0,157,16,26,199
23/5/16 21:00,1,127,13,19,160
23/5/16 22:00,0,86,8,10,104
23/5/16 23:00,0,63,5,13,81
24/5/16 0:00,0,49,7,5,61
24/5/16 1:00,0,30,6,4,40
24/5/16 2:00,0,22,11,4,37
24/5/16 3:00,1,17,5,4,27
24/5/16 4:00,0,20,9,13,42
24/5/16 5:00,0,36,11,16,63
24/5/16 6:00,0,92,14,17,123
24/5/16 7:00,1,150,22,17,190
24/5/16 8:00,0,200,20,8,228
24/5/16 9:00,0,278,23,15,316
24/5/16 10:00,3,260,13,29,305
24/5/16 11:00,1,254,14,25,294
24/5/16 12:00,6,217,21,30,274
24/5/16 13:00,1,263,22,32,318
24/5/16 14:00,2,255,15,23,295
24/5/16 15:00,2,275,25,19,321
24/5/16 16:00,2,299,14,25,340
24/5/16 17:00,0,282,18,21,321
24/5/16 18:00,5,229,23,14,271
24/5/16 19:00,4,211,10,18,243
24/5/16 20:00,0,182,9,15,206
24/5/16 21:00,1,109,15,17,142
24/5/16 22:00,0,108,8,11,127
24/5/16 23:00,0,83,6,9,98
25/5/16 0:00,0,57,9,14,80
25/5/16 1:00,0,32,10,8,50
25/5/16 2:00,0,31,5,6,42
25/5/16 3:00,0,22,12,7,41
25/5/16 4:00,0,28,10,7,45
25/5/16 5:00,0,41,12,7,60
25/5/16 6:00,0,83,14,20,117
25/5/16 7:00,1,152,30,20,203
25/5/16 8:00,3,239,15,7,264
25/5/16 9:00,1,310,29,12,352
25/5/16 10:00,6,291,22,21,340
25/5/16 11:00,2,292,13,26,333
25/5/16 12:00,3,285,23,29,340
25/5/16 13:00,4,293,24,36,357
25/5/16 14:00,5,312,21,26,364
25/5/16 15:00,2,311,28,25,366
25/5/16 16:00,2,354,25,21,402
25/5/16 17:00,4,300,23,20,347
25/5/16 18:00,6,292,14,14,326
25/5/16 19:00,4,228,21,8,261
25/5/16 20:00,0,178,10,15,203
25/5/16 21:00,1,145,17,10,173
25/5/16 22:00,0,111,11,10,132
25/5/16 23:00,0,52,5,12,69
26/5/16 0:00,1,51,5,8,65
26/5/16 1:00,0,44,9,9,62
26/5/16 2:00,1,36,9,6,52
26/5/16 3:00,0,26,18,8,52
26/5/16 4:00,0,21,11,6,38
26/5/16 5:00,1,39,10,13,63
26/5/16 6:00,0,79,15,13,107
26/5/16 7:00,0,157,17,16,190
26/5/16 8:00,1,228,16,14,259
26/5/16 9:00,3,323,31,21,378
26/5/16 10:00,2,344,18,29,393
26/5/16 11:00,1,335,30,34,400
26/5/16 12:00,0,330,17,21,368
26/5/16 13:00,5,372,24,33,434
26/5/16 14:00,6,407,19,28,460
26/5/16 15:00,5,406,17,19,447
26/5/16 16:00,5,455,20,22,502
26/5/16 17:00,4,432,16,10,462
26/5/16 18:00,2,433,20,12,467
26/5/16 19:00,2,379,24,17,422
26/5/16 20:00,1,293,10,12,316
26/5/16 21:00,0,196,15,4,215
26/5/16 22:00,0,126,11,4,141
26/5/16 23:00,0,106,6,6,118
27/5/16 0:00,0,57,4,5,66
27/5/16 1:00,1,52,10,3,66
27/5/16 2:00,0,38,5,3,46
27/5/16 3:00,0,47,10,2,59
27/5/16 4:00,0,35,11,2,48
27/5/16 5:00,0,43,5,10,58
27/5/16 6:00,1,97,16,6,120
27/5/16 7:00,1,158,18,6,183
27/5/16 8:00,4,217,20,8,249
27/5/16 9:00,4,340,22,9,375
27/5/16 10:00,1,368,27,9,405
27/5/16 11:00,5,328,14,13,360
27/5/16 12:00,6,344,12,10,372
27/5/16 13:00,3,412,18,13,446
27/5/16 14:00,1,322,10,12,345
27/5/16 15:00,5,355,13,12,385
27/5/16 16:00,7,350,20,7,384
27/5/16 17:00,0,387,18,13,418
27/5/16 18:00,7,329,16,10,362
27/5/16 19:00,7,317,20,4,348
27/5/16 20:00,2,216,16,6,240
27/5/16 21:00,0,186,7,6,199
27/5/16 22:00,1,139,9,4,153
27/5/16 23:00,0,88,6,3,97
28/5/16 0:00,0,77,9,2,88
28/5/16 1:00,0,55,8,0,63
28/5/16 2:00,0,33,8,3,44
28/5/16 3:00,0,27,6,5,38
28/5/16 4:00,0,27,4,0,31
28/5/16 5:00,0,51,8,1,60
28/5/16 6:00,0,61,8,5,74
28/5/16 7:00,0,111,9,5,125
28/5/16 8:00,0,170,7,7,184
28/5/16 9:00,5,266,16,2,289
28/5/16 10:00,7,301,19,12,339
28/5/16 11:00,2,382,19,12,415
28/5/16 12:00,7,365,12,9,393
28/5/16 13:00,9,306,17,36,368
28/5/16 14:00,2,389,13,14,418
28/5/16 15:00,2,352,10,12,376
28/5/16 16:00,5,447,22,13,487
28/5/16 17:00,8,530,21,20,579
28/5/16 18:00,8,530,21,16,575
28/5/16 19:00,14,523,22,22,581
28/5/16 20:00,7,413,16,14,450
28/5/16 21:00,7,313,14,3,337
28/5/16 22:00,3,225,14,9,251
28/5/16 23:00,0,122,7,4,133
29/5/16 0:00,1,83,7,10,101
29/5/16 1:00,0,64,5,5,74
29/5/16 2:00,1,26,10,2,39
29/5/16 3:00,0,24,12,7,43
29/5/16 4:00,0,28,8,7,43
29/5/16 5:00,1,73,7,10,91
29/5/16 6:00,0,156,10,18,184
29/5/16 7:00,0,228,12,8,248
29/5/16 8:00,1,272,8,13,294
29/5/16 9:00,1,282,20,15,318
29/5/16 10:00,9,290,16,20,335
29/5/16 11:00,1,258,23,31,313
29/5/16 12:00,1,233,13,24,271
29/5/16 13:00,11,268,11,25,315
29/5/16 14:00,3,235,15,19,272
29/5/16 15:00,3,268,15,25,311
29/5/16 16:00,1,304,17,15,337
29/5/16 17:00,3,278,20,12,313
29/5/16 18:00,5,230,17,24,276
29/5/16 19:00,2,213,18,16,249
29/5/16 20:00,0,144,4,19,167
29/5/16 21:00,0,64,8,7,79
29/5/16 22:00,1,134,10,6,151
29/5/16 23:00,0,119,10,14,143
30/5/16 0:00,0,58,6,9,73
30/5/16 1:00,0,48,14,4,66
30/5/16 2:00,0,30,5,5,40
30/5/16 3:00,0,29,9,3,41
30/5/16 4:00,0,24,14,6,44
30/5/16 5:00,0,40,8,12,60
30/5/16 6:00,0,83,19,28,130
30/5/16 7:00,0,155,16,17,188
30/5/16 8:00,2,205,20,16,243
30/5/16 9:00,4,249,14,11,278
30/5/16 10:00,0,241,19,29,289
30/5/16 11:00,2,222,13,26,263
30/5/16 12:00,6,219,18,33,276
30/5/16 13:00,3,236,15,32,286
30/5/16 14:00,7,232,15,31,285
30/5/16 15:00,1,229,17,25,272
30/5/16 16:00,7,276,18,14,315
30/5/16 17:00,7,253,15,27,302
30/5/16 18:00,0,242,10,15,267
30/5/16 19:00,3,181,10,19,213
30/5/16 20:00,2,155,9,16,182
30/5/16 21:00,0,124,14,10,148
30/5/16 22:00,0,101,13,12,126
30/5/16 23:00,1,88,11,12,112
31/5/16 0:00,0,137,9,9,155
31/5/16 1:00,0,43,4,5,52
31/5/16 2:00,0,24,10,6,40
31/5/16 3:00,0,28,8,7,43
31/5/16 4:00,0,26,8,3,37
31/5/16 5:00,0,58,8,11,77
31/5/16 6:00,0,97,12,15,124
31/5/16 7:00,0,188,16,20,224
31/5/16 8:00,0,205,16,16,237
31/5/16 9:00,5,278,16,17,316
31/5/16 10:00,2,265,16,14,297
31/5/16 11:00,1,226,15,25,267
31/5/16 12:00,4,232,19,41,296
31/5/16 13:00,3,262,12,21,298
31/5/16 14:00,2,268,21,21,312
31/5/16 15:00,11,267,18,22,318
31/5/16 16:00,3,307,16,19,345
31/5/16 17:00,1,249,15,26,291
31/5/16 18:00,6,220,16,20,262
31/5/16 19:00,10,255,24,9,298
31/5/16 20:00,0,182,12,12,206
31/5/16 21:00,0,149,13,12,174
31/5/16 22:00,0,110,9,13,132
31/5/16 23:00,0,74,6,16,96
1/6/16 0:00,0,48,9,8,65
1/6/16 1:00,0,36,10,11,57
1/6/16 2:00,0,31,9,8,48
1/6/16 3:00,0,21,7,6,34
1/6/16 4:00,0,26,10,5,41
1/6/16 5:00,0,58,16,12,86
1/6/16 6:00,2,98,19,10,129
1/6/16 7:00,2,180,20,14,216
1/6/16 8:00,3,237,23,10,273
1/6/16 9:00,1,298,25,20,344
1/6/16 10:00,6,316,9,19,350
1/6/16 11:00,2,270,17,24,313
1/6/16 12:00,4,263,20,24,311
1/6/16 13:00,5,260,26,34,325
1/6/16 14:00,2,279,21,29,331
1/6/16 15:00,4,300,20,25,349
1/6/16 16:00,2,293,17,15,327
1/6/16 17:00,0,277,23,31,331
1/6/16 18:00,0,242,17,13,272
1/6/16 19:00,0,219,14,12,245
1/6/16 20:00,0,195,10,10,215
1/6/16 21:00,1,159,13,3,176
1/6/16 22:00,0,117,15,16,148
1/6/16 23:00,0,75,8,12,95
2/6/16 0:00,0,40,9,9,58
2/6/16 1:00,0,37,5,8,50
2/6/16 2:00,1,49,9,4,63
2/6/16 3:00,4,28,8,7,47
2/6/16 4:00,0,27,8,7,42
2/6/16 5:00,1,36,4,10,51
2/6/16 6:00,0,89,20,14,123
2/6/16 7:00,0,164,13,14,191
2/6/16 8:00,2,204,17,15,238
2/6/16 9:00,3,286,21,16,326
2/6/16 10:00,3,287,28,24,342
2/6/16 11:00,10,310,15,25,360
2/6/16 12:00,13,322,20,30,385
2/6/16 13:00,0,349,16,34,399
2/6/16 14:00,4,363,17,25,409
2/6/16 15:00,4,383,13,17,417
2/6/16 16:00,8,391,17,17,433
2/6/16 17:00,1,432,15,24,472
2/6/16 18:00,3,422,22,13,460
2/6/16 19:00,0,331,14,14,359
2/6/16 20:00,1,260,13,15,289
2/6/16 21:00,1,190,13,6,210
2/6/16 22:00,0,137,12,4,153
2/6/16 23:00,0,103,6,7,116
3/6/16 0:00,0,64,6,5,75
3/6/16 1:00,0,37,6,8,51
3/6/16 2:00,0,35,9,2,46
3/6/16 3:00,0,42,9,4,55
3/6/16 4:00,0,39,7,3,49
3/6/16 5:00,0,67,4,6,77
3/6/16 6:00,0,96,14,8,118
3/6/16 7:00,0,152,9,3,164
3/6/16 8:00,3,221,19,7,250
3/6/16 9:00,2,227,24,6,259
3/6/16 10:00,3,318,13,14,348
3/6/16 11:00,8,382,14,22,426
3/6/16 12:00,5,336,14,12,367
3/6/16 13:00,7,305,6,9,327
3/6/16 14:00,4,285,9,14,312
3/6/16 15:00,6,341,9,2,358
3/6/16 16:00,8,311,12,11,342
3/6/16 17:00,2,337,14,5,358
3/6/16 18:00,2,316,12,5,335
3/6/16 19:00,16,259,15,7,297
3/6/16 20:00,2,231,9,7,249
3/6/16 21:00,0,154,10,6,170
3/6/16 22:00,1,130,11,1,143
3/6/16 23:00,0,110,12,3,125
4/6/16 0:00,0,78,9,10,97
4/6/16 1:00,1,67,7,3,78
4/6/16 2:00,0,45,4,4,53
4/6/16 3:00,0,38,4,4,46
4/6/16 4:00,0,26,7,2,35
4/6/16 5:00,0,46,5,3,54
4/6/16 6:00,0,73,7,4,84
4/6/16 7:00,2,82,3,6,93
4/6/16 8:00,2,163,11,12,188
4/6/16 9:00,8,202,13,9,232
4/6/16 10:00,6,287,12,4,309
4/6/16 11:00,2,355,11,8,376
4/6/16 12:00,10,343,11,9,373
4/6/16 13:00,6,357,9,24,396
4/6/16 14:00,21,331,14,13,379
4/6/16 15:00,4,388,15,10,417
4/6/16 16:00,4,392,11,9,416
4/6/16 17:00,8,455,12,22,497
4/6/16 18:00,4,466,22,14,506
4/6/16 19:00,27,502,17,14,560
4/6/16 20:00,3,418,23,15,459
4/6/16 21:00,3,296,20,15,334
4/6/16 22:00,1,173,14,14,202
4/6/16 23:00,1,123,9,4,137
5/6/16 0:00,0,86,10,4,100
5/6/16 1:00,0,55,5,9,69
5/6/16 2:00,0,39,8,5,52
5/6/16 3:00,0,27,14,6,47
5/6/16 4:00,0,31,10,8,49
5/6/16 5:00,0,62,8,6,76
5/6/16 6:00,0,139,16,12,167
5/6/16 7:00,2,241,15,9,267
5/6/16 8:00,5,258,11,17,291
5/6/16 9:00,3,274,19,19,315
5/6/16 10:00,1,310,17,19,347
5/6/16 11:00,4,247,8,24,283
5/6/16 12:00,0,249,23,19,291
5/6/16 13:00,1,271,11,27,310
5/6/16 14:00,4,251,13,21,289
5/6/16 15:00,1,274,16,16,307
5/6/16 16:00,2,290,18,16,326
5/6/16 17:00,5,248,11,29,293
5/6/16 18:00,2,235,11,22,270
5/6/16 19:00,3,189,17,11,220
5/6/16 20:00,4,160,5,20,189
5/6/16 21:00,0,152,13,14,179
5/6/16 22:00,0,113,7,4,124
5/6/16 23:00,0,68,9,11,88
6/6/16 0:00,1,47,9,5,62
6/6/16 1:00,0,34,7,2,43
6/6/16 2:00,0,26,5,7,38
6/6/16 3:00,0,24,10,4,38
6/6/16 4:00,0,26,9,5,40
6/6/16 5:00,0,35,10,8,53
6/6/16 6:00,0,95,17,15,127
6/6/16 7:00,0,189,26,13,228
6/6/16 8:00,1,275,20,11,307
6/6/16 9:00,3,295,18,16,332
6/6/16 10:00,2,269,16,14,301
6/6/16 11:00,2,229,11,24,266
6/6/16 12:00,2,270,21,18,311
6/6/16 13:00,9,243,17,14,283
6/6/16 14:00,3,236,18,17,274
6/6/16 15:00,1,258,16,15,290
6/6/16 16:00,2,274,18,17,311
6/6/16 17:00,2,222,15,23,262
6/6/16 18:00,1,228,17,14,260
6/6/16 19:00,0,187,12,14,213
6/6/16 20:00,0,149,8,13,170
6/6/16 21:00,0,129,13,11,153
6/6/16 22:00,1,74,14,15,104
6/6/16 23:00,0,61,4,15,80
7/6/16 0:00,0,36,9,6,51
7/6/16 1:00,0,26,9,4,39
7/6/16 2:00,0,27,7,4,38
7/6/16 3:00,0,25,6,4,35
7/6/16 4:00,0,23,6,9,38
7/6/16 5:00,0,51,7,7,65
7/6/16 6:00,0,106,12,14,132
7/6/16 7:00,0,172,16,16,204
7/6/16 8:00,1,186,11,19,217
7/6/16 9:00,1,238,19,9,267
7/6/16 10:00,1,275,20,22,318
7/6/16 11:00,0,250,13,28,291
7/6/16 12:00,3,236,20,18,277
7/6/16 13:00,2,255,21,23,301
7/6/16 14:00,2,274,17,27,320
7/6/16 15:00,1,288,24,29,342
7/6/16 16:00,0,316,17,18,351
7/6/16 17:00,8,271,17,12,308
7/6/16 18:00,2,247,13,21,283
7/6/16 19:00,2,214,21,23,260
7/6/16 20:00,0,175,5,13,193
7/6/16 21:00,0,114,12,15,141
7/6/16 22:00,1,93,9,8,111
7/6/16 23:00,0,94,8,10,112
8/6/16 0:00,0,66,13,7,86
8/6/16 1:00,1,38,9,7,55
8/6/16 2:00,0,29,15,8,52
8/6/16 3:00,0,24,9,3,36
8/6/16 4:00,0,20,6,4,30
8/6/16 5:00,0,52,11,12,75
8/6/16 6:00,0,84,18,15,117
8/6/16 7:00,1,173,20,11,205
8/6/16 8:00,0,209,15,16,240
8/6/16 9:00,3,254,17,14,288
8/6/16 10:00,3,247,17,23,290
8/6/16 11:00,2,260,15,23,300
8/6/16 12:00,1,276,18,24,319
8/6/16 13:00,6,299,21,27,353
8/6/16 14:00,6,311,19,30,366
8/6/16 15:00,3,313,17,19,352
8/6/16 16:00,5,254,21,26,306
8/6/16 17:00,3,262,22,13,300
8/6/16 18:00,3,234,15,13,265
8/6/16 19:00,2,179,10,16,207
8/6/16 20:00,1,217,9,12,239
8/6/16 21:00,0,144,11,15,170
8/6/16 22:00,2,96,10,6,114
8/6/16 23:00,0,70,10,16,96
9/6/16 0:00,0,44,12,11,67
9/6/16 1:00,0,36,6,6,48
9/6/16 2:00,0,34,15,5,54
9/6/16 3:00,0,31,5,10,46
9/6/16 4:00,0,25,10,7,42
9/6/16 5:00,0,55,13,9,77
9/6/16 6:00,0,81,19,17,117
9/6/16 7:00,1,189,18,13,221
9/6/16 8:00,0,244,8,15,267
9/6/16 9:00,1,273,19,22,315
9/6/16 10:00,5,284,18,21,328
9/6/16 11:00,3,314,12,22,351
9/6/16 12:00,6,344,20,29,399
9/6/16 13:00,9,351,21,27,408
9/6/16 14:00,6,416,17,28,467
9/6/16 15:00,2,447,12,24,485
9/6/16 16:00,3,432,20,16,471
9/6/16 17:00,2,447,20,16,485
9/6/16 18:00,3,416,15,11,445
9/6/16 19:00,1,383,14,14,412
9/6/16 20:00,3,299,14,10,326
9/6/16 21:00,1,210,12,13,236
9/6/16 22:00,5,141,12,4,162
9/6/16 23:00,1,115,7,4,127
10/6/16 0:00,0,53,7,2,62
10/6/16 1:00,2,35,5,7,49
10/6/16 2:00,1,47,7,3,58
10/6/16 3:00,0,37,9,3,49
10/6/16 4:00,0,39,7,4,50
10/6/16 5:00,0,45,9,11,65
10/6/16 6:00,0,98,9,8,115
10/6/16 7:00,2,129,15,4,150
10/6/16 8:00,4,230,16,8,258
10/6/16 9:00,1,301,15,8,325
10/6/16 10:00,6,353,33,15,407
10/6/16 11:00,8,385,10,17,420
10/6/16 12:00,4,394,15,21,434
10/6/16 13:00,5,328,13,13,359
10/6/16 14:00,6,308,13,12,339
10/6/16 15:00,6,307,10,8,331
10/6/16 16:00,4,365,16,13,398
10/6/16 17:00,1,316,13,2,332
10/6/16 18:00,5,337,17,10,369
10/6/16 19:00,4,250,15,4,273
10/6/16 20:00,2,200,9,3,214
10/6/16 21:00,3,163,14,5,185
10/6/16 22:00,0,125,6,1,132
10/6/16 23:00,0,109,13,4,126
11/6/16 0:00,1,78,7,5,91
11/6/16 1:00,1,74,9,2,86
11/6/16 2:00,0,36,5,0,41
11/6/16 3:00,0,27,2,4,33
11/6/16 4:00,0,31,8,2,41
11/6/16 5:00,0,28,10,3,41
11/6/16 6:00,0,84,7,4,95
11/6/16 7:00,0,110,8,9,127
11/6/16 8:00,2,199,11,7,219
11/6/16 9:00,2,239,15,10,266
11/6/16 10:00,5,334,15,8,362
11/6/16 11:00,8,372,9,12,401
11/6/16 12:00,12,384,9,10,415
11/6/16 13:00,2,360,13,15,390
11/6/16 14:00,11,341,14,11,377
11/6/16 15:00,12,342,9,13,376
11/6/16 16:00,7,409,12,11,439
11/6/16 17:00,10,487,18,25,540
11/6/16 18:00,6,544,15,18,583
11/6/16 19:00,7,539,10,19,575
11/6/16 20:00,4,401,19,13,437
11/6/16 21:00,13,269,15,9,306
11/6/16 22:00,1,188,16,13,218
11/6/16 23:00,1,116,9,10,136
12/6/16 0:00,0,76,7,1,84
12/6/16 1:00,1,68,11,6,86
12/6/16 2:00,0,32,9,3,44
12/6/16 3:00,0,19,12,8,39
12/6/16 4:00,0,28,8,4,40
12/6/16 5:00,0,56,10,6,72
12/6/16 6:00,0,149,11,9,169
12/6/16 7:00,3,239,13,15,270
12/6/16 8:00,0,274,12,13,299
12/6/16 9:00,2,310,18,15,345
12/6/16 10:00,3,296,15,13,327
12/6/16 11:00,4,269,16,28,317
12/6/16 12:00,2,290,13,28,333
12/6/16 13:00,2,247,17,18,284
12/6/16 14:00,0,275,18,23,316
12/6/16 15:00,1,270,18,18,307
12/6/16 16:00,1,287,14,13,315
12/6/16 17:00,3,233,20,21,277
12/6/16 18:00,3,256,17,19,295
12/6/16 19:00,1,202,10,15,228
12/6/16 20:00,0,150,8,5,163
12/6/16 21:00,0,137,13,15,165
12/6/16 22:00,0,111,10,7,128
12/6/16 23:00,1,82,7,12,102
13/6/16 0:00,1,55,6,10,72
13/6/16 1:00,0,44,3,5,52
13/6/16 2:00,1,27,6,6,40
13/6/16 3:00,0,31,4,2,37
13/6/16 4:00,0,18,8,5,31
13/6/16 5:00,0,44,11,10,65
13/6/16 6:00,0,76,15,8,99
13/6/16 7:00,1,185,11,14,211
13/6/16 8:00,0,252,15,4,271
13/6/16 9:00,3,280,9,11,303
13/6/16 10:00,3,263,17,23,306
13/6/16 11:00,0,284,16,21,321
13/6/16 12:00,1,276,12,19,308
13/6/16 13:00,1,299,21,16,337
13/6/16 14:00,2,309,16,21,348
13/6/16 15:00,2,280,9,22,313
13/6/16 16:00,7,261,19,27,314
13/6/16 17:00,5,275,15,21,316
13/6/16 18:00,2,254,14,15,285
13/6/16 19:00,1,189,8,15,213
13/6/16 20:00,0,158,13,10,181
13/6/16 21:00,2,120,13,13,148
13/6/16 22:00,0,86,9,12,107
13/6/16 23:00,0,97,5,11,113
14/6/16 0:00,0,42,9,6,57
14/6/16 1:00,0,36,7,7,50
14/6/16 2:00,0,32,6,6,44
14/6/16 3:00,0,21,7,6,34
14/6/16 4:00,0,27,13,7,47
14/6/16 5:00,0,39,13,13,65
14/6/16 6:00,0,99,15,19,133
14/6/16 7:00,2,188,15,13,218
14/6/16 8:00,1,216,7,17,241
14/6/16 9:00,2,313,19,9,343
14/6/16 10:00,4,295,16,13,328
14/6/16 11:00,2,288,17,17,324
14/6/16 12:00,6,269,18,21,314
14/6/16 13:00,3,294,16,32,345
14/6/16 14:00,3,277,17,20,317
14/6/16 15:00,9,300,16,10,335
14/6/16 16:00,0,302,14,15,331
14/6/16 17:00,0,265,15,21,301
14/6/16 18:00,2,265,15,21,303
14/6/16 19:00,2,186,13,18,219
14/6/16 20:00,0,191,7,10,208
14/6/16 21:00,1,150,15,14,180
14/6/16 22:00,0,120,9,17,146
14/6/16 23:00,1,70,6,15,92
15/6/16 0:00,1,55,6,13,75
15/6/16 1:00,0,41,6,7,54
15/6/16 2:00,0,19,6,7,32
15/6/16 3:00,0,36,3,2,41
15/6/16 4:00,0,25,10,8,43
15/6/16 5:00,0,74,14,6,94
15/6/16 6:00,1,115,15,17,148
15/6/16 7:00,3,188,22,10,223
15/6/16 8:00,6,273,13,8,300
15/6/16 9:00,10,316,15,9,350
15/6/16 10:00,4,344,26,37,411
15/6/16 11:00,7,349,17,25,398
15/6/16 12:00,12,319,22,24,377
15/6/16 13:00,3,322,22,32,379
15/6/16 14:00,7,346,13,37,403
15/6/16 15:00,5,351,25,28,409
15/6/16 16:00,6,349,21,32,408
15/6/16 17:00,1,326,20,21,368
15/6/16 18:00,4,306,20,21,351
15/6/16 19:00,2,269,8,12,291
15/6/16 20:00,3,220,3,16,242
15/6/16 21:00,5,175,18,10,208
15/6/16 22:00,2,160,9,21,192
15/6/16 23:00,0,86,12,15,113
16/6/16 0:00,0,66,7,8,81
16/6/16 1:00,2,45,9,4,60
16/6/16 2:00,0,40,13,7,60
16/6/16 3:00,0,27,10,4,41
16/6/16 4:00,2,37,5,5,49
16/6/16 5:00,0,56,9,8,73
16/6/16 6:00,2,91,11,13,117
16/6/16 7:00,6,206,16,16,244
16/6/16 8:00,22,265,16,13,316
16/6/16 9:00,4,330,22,10,366
16/6/16 10:00,8,430,17,22,477
16/6/16 11:00,4,453,19,16,492
16/6/16 12:00,15,496,21,22,554
16/6/16 13:00,15,474,20,29,538
16/6/16 14:00,8,627,14,31,680
16/6/16 15:00,20,560,21,21,622
16/6/16 16:00,16,547,21,26,610
16/6/16 17:00,20,571,19,9,619
16/6/16 18:00,10,573,17,12,612
16/6/16 19:00,12,529,15,12,568
16/6/16 20:00,9,412,13,12,446
16/6/16 21:00,4,337,15,3,359
16/6/16 22:00,3,208,15,1,227
16/6/16 23:00,0,136,4,8,148
17/6/16 0:00,3,67,9,3,82
17/6/16 1:00,0,54,6,3,63
17/6/16 2:00,1,47,9,2,59
17/6/16 3:00,0,40,5,5,50
17/6/16 4:00,0,39,11,7,57
17/6/16 5:00,0,56,9,5,70
17/6/16 6:00,3,137,8,8,156
17/6/16 7:00,9,249,18,12,288
17/6/16 8:00,21,330,20,9,380
17/6/16 9:00,32,511,25,14,582
17/6/16 10:00,17,695,17,15,744
17/6/16 11:00,14,752,6,30,802
17/6/16 12:00,15,740,15,12,782
17/6/16 13:00,17,589,12,19,637
17/6/16 14:00,10,481,14,20,525
17/6/16 15:00,24,467,10,6,507
17/6/16 16:00,11,558,15,12,596
17/6/16 17:00,14,521,11,10,556
17/6/16 18:00,11,483,16,8,518
17/6/16 19:00,7,354,10,6,377
17/6/16 20:00,11,286,2,6,305
17/6/16 21:00,4,192,10,6,212
17/6/16 22:00,0,164,9,4,177
17/6/16 23:00,2,103,4,1,110
18/6/16 0:00,0,87,8,2,97
18/6/16 1:00,1,43,6,2,52
18/6/16 2:00,0,44,4,3,51
18/6/16 3:00,0,53,4,4,61
18/6/16 4:00,0,30,9,3,42
18/6/16 5:00,0,47,7,0,54
18/6/16 6:00,0,86,8,4,98
18/6/16 7:00,2,128,9,6,145
18/6/16 8:00,7,201,11,10,229
18/6/16 9:00,10,300,13,4,327
18/6/16 10:00,5,461,16,11,493
18/6/16 11:00,6,585,13,14,618
18/6/16 12:00,15,530,14,12,571
18/6/16 13:00,17,481,14,15,527
18/6/16 14:00,7,394,13,9,423
18/6/16 15:00,5,403,7,6,421
18/6/16 16:00,29,442,13,19,503
18/6/16 17:00,28,460,11,15,514
18/6/16 18:00,10,419,14,22,465
18/6/16 19:00,13,378,18,10,419
18/6/16 20:00,13,332,10,15,370
18/6/16 21:00,14,219,13,8,254
18/6/16 22:00,2,139,8,2,151
18/6/16 23:00,0,128,7,6,141
19/6/16 0:00,4,100,9,5,118
19/6/16 1:00,1,77,4,3,85
19/6/16 2:00,1,49,5,7,62
19/6/16 3:00,0,26,6,3,35
19/6/16 4:00,0,27,5,3,35
19/6/16 5:00,0,38,10,4,52
19/6/16 6:00,3,100,8,8,119
19/6/16 7:00,1,154,6,11,172
19/6/16 8:00,11,204,14,12,241
19/6/16 9:00,11,252,13,11,287
19/6/16 10:00,17,356,10,26,409
19/6/16 11:00,11,484,11,24,530
19/6/16 12:00,17,572,17,18,624
19/6/16 13:00,24,555,10,14,603
19/6/16 14:00,24,489,11,18,542
19/6/16 15:00,14,503,9,11,537
19/6/16 16:00,18,618,14,13,663
19/6/16 17:00,22,663,12,8,705
19/6/16 18:00,21,735,24,7,787
19/6/16 19:00,17,687,26,8,738
19/6/16 20:00,11,611,19,16,657
19/6/16 21:00,16,488,16,8,528
19/6/16 22:00,0,294,10,10,314
19/6/16 23:00,3,209,8,10,230
20/6/16 0:00,3,89,12,6,110
20/6/16 1:00,1,62,8,5,76
20/6/16 2:00,0,51,5,3,59
20/6/16 3:00,0,46,6,8,60
20/6/16 4:00,0,42,10,5,57
20/6/16 5:00,1,69,7,9,86
20/6/16 6:00,1,167,17,18,203
20/6/16 7:00,2,311,23,9,345
20/6/16 8:00,3,349,17,24,393
20/6/16 9:00,1,332,13,12,358
20/6/16 10:00,0,376,23,21,420
20/6/16 11:00,3,393,13,24,433
20/6/16 12:00,2,353,14,26,395
20/6/16 13:00,4,313,11,24,352
20/6/16 14:00,0,331,18,30,379
20/6/16 15:00,2,346,12,16,376
20/6/16 16:00,7,329,22,17,375
20/6/16 17:00,4,304,18,13,339
20/6/16 18:00,5,283,16,13,317
20/6/16 19:00,4,252,12,22,290
20/6/16 20:00,6,242,12,21,281
20/6/16 21:00,1,184,12,13,210
20/6/16 22:00,2,150,12,17,181
20/6/16 23:00,7,97,12,7,123
21/6/16 0:00,0,91,6,10,107
21/6/16 1:00,1,56,9,11,77
21/6/16 2:00,0,32,9,8,49
21/6/16 3:00,0,44,8,6,58
21/6/16 4:00,0,46,14,8,68
21/6/16 5:00,0,47,15,11,73
21/6/16 6:00,0,139,19,9,167
21/6/16 7:00,4,283,20,16,323
21/6/16 8:00,4,305,12,9,330
21/6/16 9:00,4,367,16,14,401
21/6/16 10:00,3,394,18,18,433
21/6/16 11:00,3,359,26,24,412
21/6/16 12:00,11,373,19,31,434
21/6/16 13:00,2,321,14,24,361
21/6/16 14:00,2,333,25,24,384
21/6/16 15:00,2,363,10,14,389
21/6/16 16:00,2,296,18,21,337
21/6/16 17:00,2,344,21,14,381
21/6/16 18:00,7,364,12,7,390
21/6/16 19:00,4,283,19,10,316
21/6/16 20:00,0,211,10,12,233
21/6/16 21:00,0,177,15,13,205
21/6/16 22:00,1,141,12,14,168
21/6/16 23:00,1,112,5,13,131
22/6/16 0:00,1,69,9,6,85
22/6/16 1:00,1,63,6,13,83
22/6/16 2:00,0,39,9,9,57
22/6/16 3:00,0,38,8,12,58
22/6/16 4:00,0,39,9,12,60
22/6/16 5:00,1,62,13,5,81
22/6/16 6:00,1,118,15,19,153
22/6/16 7:00,1,229,21,13,264
22/6/16 8:00,2,317,24,12,355
22/6/16 9:00,6,345,15,14,380
22/6/16 10:00,1,317,22,17,357
22/6/16 11:00,2,298,18,26,344
22/6/16 12:00,3,347,18,19,387
22/6/16 13:00,5,363,15,23,406
22/6/16 14:00,3,371,15,24,413
22/6/16 15:00,4,358,15,20,397
22/6/16 16:00,4,367,24,26,421
22/6/16 17:00,5,315,18,18,356
22/6/16 18:00,1,299,19,22,341
22/6/16 19:00,3,287,12,7,309
22/6/16 20:00,2,254,14,13,283
22/6/16 21:00,0,208,25,14,247
22/6/16 22:00,2,130,8,18,158
22/6/16 23:00,0,103,8,19,130
23/6/16 0:00,0,67,7,10,84
23/6/16 1:00,0,38,12,8,58
23/6/16 2:00,0,44,12,5,61
23/6/16 3:00,0,33,7,4,44
23/6/16 4:00,0,33,10,5,48
23/6/16 5:00,1,75,4,10,90
23/6/16 6:00,3,113,15,21,152
23/6/16 7:00,5,201,13,12,231
23/6/16 8:00,1,278,22,12,313
23/6/16 9:00,1,322,18,20,361
23/6/16 10:00,1,386,22,20,429
23/6/16 11:00,3,443,19,30,495
23/6/16 12:00,7,481,25,34,547
23/6/16 13:00,5,494,23,23,545
23/6/16 14:00,7,468,25,26,526
23/6/16 15:00,4,515,13,21,553
23/6/16 16:00,4,530,21,23,578
23/6/16 17:00,2,497,13,12,524
23/6/16 18:00,6,524,23,7,560
23/6/16 19:00,8,480,19,8,515
23/6/16 20:00,4,401,19,13,437
23/6/16 21:00,1,267,23,13,304
23/6/16 22:00,3,246,7,9,265
23/6/16 23:00,4,148,9,21,182
24/6/16 0:00,3,116,11,17,147
24/6/16 1:00,1,83,8,3,95
24/6/16 2:00,1,61,7,5,74
24/6/16 3:00,1,51,2,4,58
24/6/16 4:00,0,29,8,0,37
24/6/16 5:00,0,86,7,18,111
24/6/16 6:00,2,131,8,6,147
24/6/16 7:00,3,219,14,9,245
24/6/16 8:00,4,329,21,9,363
24/6/16 9:00,5,414,13,13,445
24/6/16 10:00,6,495,26,14,541
24/6/16 11:00,10,606,15,19,650
24/6/16 12:00,10,630,18,24,682
24/6/16 13:00,1,545,9,21,576
24/6/16 14:00,8,513,15,15,551
24/6/16 15:00,11,481,6,15,513
24/6/16 16:00,16,528,17,13,574
24/6/16 17:00,8,521,9,11,549
24/6/16 18:00,7,490,14,9,520
24/6/16 19:00,4,383,6,9,402
24/6/16 20:00,6,293,7,9,315
24/6/16 21:00,3,255,11,5,274
24/6/16 22:00,3,159,5,6,173
24/6/16 23:00,0,136,9,8,153
25/6/16 0:00,0,102,7,7,116
25/6/16 1:00,1,110,9,7,127
25/6/16 2:00,0,72,10,1,83
25/6/16 3:00,0,51,2,6,59
25/6/16 4:00,0,52,2,1,55
25/6/16 5:00,0,60,4,2,66
25/6/16 6:00,0,104,13,5,122
25/6/16 7:00,3,172,4,3,182
25/6/16 8:00,1,249,10,8,268
25/6/16 9:00,6,328,11,8,353
25/6/16 10:00,7,461,22,8,498
25/6/16 11:00,4,501,13,14,532
25/6/16 12:00,6,590,11,13,620
25/6/16 13:00,11,515,21,20,567
25/6/16 14:00,7,503,14,21,545
25/6/16 15:00,4,486,10,11,511
25/6/16 16:00,3,542,15,4,564
25/6/16 17:00,1,574,12,14,601
25/6/16 18:00,11,603,18,17,649
25/6/16 19:00,16,578,17,16,627
25/6/16 20:00,0,482,13,17,512
25/6/16 21:00,3,353,17,6,379
25/6/16 22:00,3,242,14,10,269
25/6/16 23:00,2,178,13,7,200
26/6/16 0:00,1,119,13,9,142
26/6/16 1:00,0,79,9,3,91
26/6/16 2:00,0,51,9,6,66
26/6/16 3:00,0,64,4,6,74
26/6/16 4:00,1,38,9,5,53
26/6/16 5:00,0,83,9,9,101
26/6/16 6:00,1,192,11,15,219
26/6/16 7:00,1,341,17,9,368
26/6/16 8:00,2,381,16,9,408
26/6/16 9:00,2,411,12,11,436
26/6/16 10:00,4,407,15,15,441
26/6/16 11:00,4,461,12,32,509
26/6/16 12:00,4,406,17,23,450
26/6/16 13:00,5,392,21,28,446
26/6/16 14:00,3,418,13,16,450
26/6/16 15:00,1,417,12,25,455
26/6/16 16:00,3,359,22,24,408
26/6/16 17:00,2,336,19,12,369
26/6/16 18:00,5,301,13,14,333
26/6/16 19:00,3,307,15,18,343
26/6/16 20:00,2,243,11,11,267
26/6/16 21:00,2,197,15,13,227
26/6/16 22:00,1,132,11,19,163
26/6/16 23:00,3,113,9,12,137
27/6/16 0:00,0,58,6,10,74
27/6/16 1:00,0,43,9,7,59
27/6/16 2:00,0,30,13,7,50
27/6/16 3:00,0,30,7,0,37
27/6/16 4:00,1,35,11,5,52
27/6/16 5:00,0,53,11,19,83
27/6/16 6:00,0,123,17,29,169
27/6/16 7:00,0,232,17,15,264
27/6/16 8:00,3,303,18,19,343
27/6/16 9:00,2,348,11,22,383
27/6/16 10:00,0,353,22,21,396
27/6/16 11:00,6,349,15,23,393
27/6/16 12:00,2,316,15,26,359
27/6/16 13:00,1,331,23,38,393
27/6/16 14:00,4,332,13,19,368
27/6/16 15:00,0,336,19,19,374
27/6/16 16:00,2,330,17,18,367
27/6/16 17:00,2,305,16,9,332
27/6/16 18:00,10,376,20,11,417
27/6/16 19:00,6,319,11,15,351
27/6/16 20:00,0,228,9,15,252
27/6/16 21:00,2,167,14,9,192
27/6/16 22:00,2,128,16,23,169
27/6/16 23:00,0,95,6,22,123
28/6/16 0:00,1,46,11,6,64
28/6/16 1:00,0,51,7,1,59
28/6/16 2:00,0,43,8,9,60
28/6/16 3:00,1,38,9,6,54
28/6/16 4:00,0,33,10,11,54
28/6/16 5:00,0,48,18,10,76
28/6/16 6:00,1,160,14,21,196
28/6/16 7:00,9,244,25,18,296
28/6/16 8:00,1,295,13,18,327
28/6/16 9:00,11,346,20,17,394
28/6/16 10:00,2,384,22,21,429
28/6/16 11:00,5,360,11,15,391
28/6/16 12:00,5,388,19,26,438
28/6/16 13:00,4,317,18,32,371
28/6/16 14:00,2,330,29,21,382
28/6/16 15:00,2,402,17,17,438
28/6/16 16:00,7,361,21,19,408
28/6/16 17:00,15,346,16,13,390
28/6/16 18:00,0,333,21,22,376
28/6/16 19:00,3,302,22,6,333
28/6/16 20:00,1,244,9,13,267
28/6/16 21:00,0,213,15,12,240
28/6/16 22:00,3,168,14,12,197
28/6/16 23:00,1,104,10,14,129
29/6/16 0:00,0,80,8,5,93
29/6/16 1:00,3,63,8,13,87
29/6/16 2:00,0,48,9,9,66
29/6/16 3:00,0,34,3,5,42
29/6/16 4:00,0,37,11,10,58
29/6/16 5:00,0,58,12,11,81
29/6/16 6:00,1,144,14,24,183
29/6/16 7:00,0,253,26,12,291
29/6/16 8:00,2,324,19,13,358
29/6/16 9:00,1,360,26,17,404
29/6/16 10:00,2,391,24,14,431
29/6/16 11:00,2,442,18,19,481
29/6/16 12:00,8,502,24,25,559
29/6/16 13:00,1,467,22,28,518
29/6/16 14:00,3,444,18,35,500
29/6/16 15:00,4,437,24,25,490
29/6/16 16:00,1,415,20,30,466
29/6/16 17:00,1,364,12,22,399
29/6/16 18:00,6,344,17,12,379
29/6/16 19:00,6,340,12,15,373
29/6/16 20:00,0,259,16,12,287
29/6/16 21:00,1,207,20,20,248
29/6/16 22:00,0,171,17,9,197
29/6/16 23:00,1,120,6,12,139
30/6/16 0:00,0,85,11,14,110
30/6/16 1:00,0,61,7,12,80
30/6/16 2:00,0,36,14,4,54
30/6/16 3:00,0,41,5,2,48
30/6/16 4:00,0,31,9,4,44
30/6/16 5:00,0,94,9,13,116
30/6/16 6:00,0,140,13,17,170
30/6/16 7:00,2,234,18,15,269
30/6/16 8:00,3,332,19,12,366
30/6/16 9:00,13,412,14,13,452
30/6/16 10:00,5,478,25,16,524
30/6/16 11:00,7,569,12,23,611
30/6/16 12:00,6,615,26,22,669
30/6/16 13:00,3,577,17,36,633
30/6/16 14:00,18,669,12,18,717
30/6/16 15:00,5,608,15,12,640
30/6/16 16:00,8,550,10,20,588
30/6/16 17:00,4,696,19,9,728
30/6/16 18:00,2,650,20,15,687
30/6/16 19:00,6,596,20,15,637
30/6/16 20:00,10,455,16,13,494
30/6/16 21:00,2,307,14,14,337
30/6/16 22:00,0,226,14,12,252
30/6/16 23:00,1,146,6,9,162
1/7/16 0:00,0,81,7,4,92
1/7/16 1:00,0,102,7,2,111
1/7/16 2:00,1,73,13,1,88
1/7/16 3:00,1,63,9,4,77
1/7/16 4:00,0,71,8,2,81
1/7/16 5:00,2,88,7,2,99
1/7/16 6:00,1,166,16,5,188
1/7/16 7:00,1,244,21,14,280
1/7/16 8:00,3,398,17,9,427
1/7/16 9:00,3,568,26,10,607
1/7/16 10:00,9,647,19,7,682
1/7/16 11:00,9,721,16,11,757
1/7/16 12:00,8,768,11,15,802
1/7/16 13:00,12,676,18,21,727
1/7/16 14:00,13,644,14,13,684
1/7/16 15:00,9,668,14,7,698
1/7/16 16:00,7,546,14,5,572
1/7/16 17:00,24,676,27,7,734
1/7/16 18:00,10,584,20,4,618
1/7/16 19:00,18,530,19,8,575
1/7/16 20:00,1,363,14,8,386
1/7/16 21:00,5,255,11,4,275
1/7/16 22:00,2,233,12,2,249
1/7/16 23:00,2,150,6,2,160
2/7/16 0:00,2,115,10,2,129
2/7/16 1:00,2,119,6,4,131
2/7/16 2:00,0,84,9,2,95
2/7/16 3:00,3,65,13,4,85
2/7/16 4:00,0,76,6,3,85
2/7/16 5:00,0,60,7,1,68
2/7/16 6:00,1,119,15,1,136
2/7/16 7:00,2,193,9,6,210
2/7/16 8:00,8,288,15,2,313
2/7/16 9:00,18,370,15,5,408
2/7/16 10:00,8,559,14,7,588
2/7/16 11:00,10,695,17,14,736
2/7/16 12:00,21,730,19,14,784
2/7/16 13:00,7,612,24,11,654
2/7/16 14:00,17,589,18,14,638
2/7/16 15:00,6,680,15,9,710
2/7/16 16:00,9,639,17,1,666
2/7/16 17:00,11,667,16,12,706
2/7/16 18:00,5,664,14,13,696
2/7/16 19:00,9,636,16,8,669
2/7/16 20:00,5,614,12,9,640
2/7/16 21:00,5,542,18,9,574
2/7/16 22:00,3,274,11,15,303
2/7/16 23:00,1,245,7,14,267
3/7/16 0:00,0,132,10,8,150
3/7/16 1:00,0,58,9,8,75
3/7/16 2:00,0,54,14,4,72
3/7/16 3:00,0,57,7,11,75
3/7/16 4:00,0,57,7,6,70
3/7/16 5:00,1,122,8,8,139
3/7/16 6:00,0,217,15,5,237
3/7/16 7:00,6,368,19,10,403
3/7/16 8:00,4,418,11,13,446
3/7/16 9:00,11,463,14,16,504
3/7/16 10:00,8,502,17,25,552
3/7/16 11:00,8,549,12,18,587
3/7/16 12:00,14,519,13,21,567
3/7/16 13:00,4,472,17,21,514
3/7/16 14:00,3,440,19,24,486
3/7/16 15:00,8,441,12,16,477
3/7/16 16:00,3,459,14,19,495
3/7/16 17:00,2,393,13,10,418
3/7/16 18:00,0,377,13,19,409
3/7/16 19:00,2,319,13,10,344
3/7/16 20:00,5,264,10,11,290
3/7/16 21:00,0,178,11,8,197
3/7/16 22:00,1,141,12,8,162
3/7/16 23:00,4,109,10,13,136
4/7/16 0:00,0,72,10,5,87
4/7/16 1:00,0,48,13,6,67
4/7/16 2:00,0,43,8,8,59
4/7/16 3:00,0,38,4,5,47
4/7/16 4:00,0,32,13,5,50
4/7/16 5:00,2,68,7,4,81
4/7/16 6:00,0,140,15,18,173
4/7/16 7:00,2,198,23,25,248
4/7/16 8:00,2,318,21,9,350
4/7/16 9:00,9,421,13,10,453
4/7/16 10:00,6,413,18,26,463
4/7/16 11:00,2,474,13,20,509
4/7/16 12:00,9,477,16,25,527
4/7/16 13:00,6,419,24,14,463
4/7/16 14:00,5,371,19,23,418
4/7/16 15:00,6,372,22,33,433
4/7/16 16:00,4,366,15,17,402
4/7/16 17:00,7,385,22,20,434
4/7/16 18:00,4,397,13,23,437
4/7/16 19:00,11,355,17,22,405
4/7/16 20:00,4,245,18,13,280
4/7/16 21:00,3,205,10,7,225
4/7/16 22:00,2,156,7,10,175
4/7/16 23:00,1,109,8,13,131
5/7/16 0:00,1,72,8,13,94
5/7/16 1:00,0,58,11,3,72
5/7/16 2:00,0,37,7,3,47
5/7/16 3:00,0,33,6,2,41
5/7/16 4:00,0,38,8,5,51
5/7/16 5:00,0,58,7,9,74
5/7/16 6:00,0,164,16,20,200
5/7/16 7:00,4,318,21,18,361
5/7/16 8:00,1,321,16,17,355
5/7/16 9:00,6,370,15,20,411
5/7/16 10:00,9,445,22,33,509
5/7/16 11:00,13,464,18,24,519
5/7/16 12:00,12,485,18,38,553
5/7/16 13:00,4,472,18,39,533
5/7/16 14:00,4,433,18,17,472
5/7/16 15:00,6,474,18,22,520
5/7/16 16:00,5,433,20,19,477
5/7/16 17:00,7,353,12,10,382
5/7/16 18:00,1,309,20,18,348
5/7/16 19:00,3,267,14,14,298
5/7/16 20:00,0,245,11,16,272
5/7/16 21:00,2,195,8,12,217
5/7/16 22:00,0,130,14,18,162
5/7/16 23:00,3,107,9,8,127
6/7/16 0:00,1,80,11,14,106
6/7/16 1:00,0,45,10,3,58
6/7/16 2:00,0,37,8,4,49
6/7/16 3:00,0,29,10,9,48
6/7/16 4:00,0,39,14,4,57
6/7/16 5:00,1,78,16,2,97
6/7/16 6:00,2,160,18,20,200
6/7/16 7:00,2,285,26,23,336
6/7/16 8:00,3,357,14,9,383
6/7/16 9:00,3,419,20,9,451
6/7/16 10:00,6,502,20,28,556
6/7/16 11:00,10,579,20,28,637
6/7/16 12:00,5,687,17,33,742
6/7/16 13:00,8,599,24,33,664
6/7/16 14:00,5,512,21,21,559
6/7/16 15:00,13,460,22,18,513
6/7/16 16:00,1,426,29,22,478
6/7/16 17:00,6,449,13,9,477
6/7/16 18:00,6,382,20,6,414
6/7/16 19:00,1,297,25,8,331
6/7/16 20:00,2,265,9,17,293
6/7/16 21:00,2,202,12,7,223
6/7/16 22:00,3,157,14,13,187
6/7/16 23:00,0,111,12,13,136
7/7/16 0:00,1,70,11,11,93
7/7/16 1:00,0,57,8,10,75
7/7/16 2:00,1,29,7,7,44
7/7/16 3:00,0,46,6,8,60
7/7/16 4:00,0,47,10,5,62
7/7/16 5:00,0,45,13,4,62
7/7/16 6:00,0,118,10,21,149
7/7/16 7:00,3,241,15,12,271
7/7/16 8:00,4,270,13,18,305
7/7/16 9:00,2,419,12,17,450
7/7/16 10:00,7,477,21,19,524
7/7/16 11:00,12,662,9,36,719
7/7/16 12:00,13,672,16,37,738
7/7/16 13:00,6,569,15,31,621
7/7/16 14:00,16,600,22,21,659
7/7/16 15:00,13,579,22,24,638
7/7/16 16:00,8,623,24,22,677
7/7/16 17:00,11,570,18,9,608
7/7/16 18:00,14,591,23,12,640
7/7/16 19:00,7,479,22,8,516
7/7/16 20:00,17,429,16,5,467
7/7/16 21:00,6,352,11,14,383
7/7/16 22:00,7,245,15,4,271
7/7/16 23:00,3,158,5,3,169
8/7/16 0:00,0,116,12,3,131
8/7/16 1:00,3,84,12,7,106
8/7/16 2:00,1,60,6,1,68
8/7/16 3:00,1,61,7,1,70
8/7/16 4:00,0,71,8,5,84
8/7/16 5:00,0,66,4,2,72
8/7/16 6:00,1,147,9,4,161
8/7/16 7:00,1,259,21,5,286
8/7/16 8:00,10,330,15,6,361
8/7/16 9:00,2,505,22,15,544
8/7/16 10:00,8,583,18,7,616
8/7/16 11:00,12,669,20,4,705
8/7/16 12:00,14,761,24,11,810
8/7/16 13:00,22,751,11,8,792
8/7/16 14:00,11,571,12,6,600
8/7/16 15:00,13,584,7,7,611
8/7/16 16:00,6,600,22,6,634
8/7/16 17:00,12,596,18,8,634
8/7/16 18:00,9,546,16,7,578
8/7/16 19:00,9,429,10,6,454
8/7/16 20:00,9,486,17,6,518
8/7/16 21:00,5,311,12,4,332
8/7/16 22:00,1,233,5,7,246
8/7/16 23:00,2,157,10,5,174
9/7/16 0:00,0,136,7,2,145
9/7/16 1:00,1,144,10,4,159
9/7/16 2:00,1,80,7,1,89
9/7/16 3:00,1,120,10,3,134
9/7/16 4:00,0,87,7,2,96
9/7/16 5:00,3,102,11,3,119
9/7/16 6:00,2,151,5,5,163
9/7/16 7:00,2,210,6,6,224
9/7/16 8:00,3,276,16,7,302
9/7/16 9:00,6,417,14,2,439
9/7/16 10:00,11,572,17,7,607
9/7/16 11:00,7,740,16,6,769
9/7/16 12:00,14,813,19,12,858
9/7/16 13:00,2,696,18,7,723
9/7/16 14:00,4,671,12,13,700
9/7/16 15:00,13,573,9,11,606
9/7/16 16:00,8,665,15,8,696
9/7/16 17:00,8,645,14,20,687
9/7/16 18:00,9,726,20,20,775
9/7/16 19:00,13,688,16,5,722
9/7/16 20:00,11,643,13,6,673
9/7/16 21:00,8,446,20,10,484
9/7/16 22:00,4,275,10,11,300
9/7/16 23:00,2,245,20,12,279
10/7/16 0:00,1,139,11,4,155
10/7/16 1:00,0,133,12,8,153
10/7/16 2:00,0,99,7,4,110
10/7/16 3:00,2,68,13,6,89
10/7/16 4:00,1,79,5,7,92
10/7/16 5:00,3,107,9,10,129
10/7/16 6:00,0,225,13,8,246
10/7/16 7:00,1,406,22,11,440
10/7/16 8:00,1,457,15,8,481
10/7/16 9:00,6,471,20,13,510
10/7/16 10:00,10,517,20,28,575
10/7/16 11:00,6,568,22,17,613
10/7/16 12:00,4,586,15,16,621
10/7/16 13:00,8,549,23,14,594
10/7/16 14:00,5,460,18,21,504
10/7/16 15:00,4,446,11,15,476
10/7/16 16:00,2,483,16,14,515
10/7/16 17:00,3,406,19,13,441
10/7/16 18:00,6,375,14,12,407
10/7/16 19:00,4,351,15,11,381
10/7/16 20:00,3,321,11,9,344
10/7/16 21:00,0,252,11,10,273
10/7/16 22:00,0,214,13,11,238
10/7/16 23:00,1,182,7,12,202
11/7/16 0:00,2,121,12,6,141
11/7/16 1:00,0,87,7,4,98
11/7/16 2:00,0,63,9,8,80
11/7/16 3:00,1,61,12,4,78
11/7/16 4:00,0,32,10,3,45
11/7/16 5:00,0,71,14,13,98
11/7/16 6:00,0,161,16,16,193
11/7/16 7:00,4,254,23,15,296
11/7/16 8:00,2,399,14,13,428
11/7/16 9:00,5,448,11,13,477
11/7/16 10:00,2,530,22,19,573
11/7/16 11:00,12,531,16,18,577
11/7/16 12:00,8,545,18,9,580
11/7/16 13:00,6,515,17,25,563
11/7/16 14:00,2,394,11,12,419
11/7/16 15:00,8,411,8,13,440
11/7/16 16:00,7,437,31,22,497
11/7/16 17:00,4,433,21,20,478
11/7/16 18:00,8,478,15,19,520
11/7/16 19:00,2,345,16,20,383
11/7/16 20:00,1,254,11,12,278
11/7/16 21:00,2,182,10,10,204
11/7/16 22:00,1,179,12,11,203
11/7/16 23:00,2,135,14,19,170
12/7/16 0:00,0,97,9,11,117
12/7/16 1:00,1,69,10,9,89
12/7/16 2:00,0,45,8,5,58
12/7/16 3:00,0,35,11,4,50
12/7/16 4:00,0,39,15,4,58
12/7/16 5:00,0,67,13,12,92
12/7/16 6:00,1,159,8,16,184
12/7/16 7:00,3,331,20,14,368
12/7/16 8:00,2,330,25,16,373
12/7/16 9:00,4,406,14,12,436
12/7/16 10:00,10,443,18,23,494
12/7/16 11:00,10,455,13,32,510
12/7/16 12:00,2,444,17,23,486
12/7/16 13:00,3,439,20,29,491
12/7/16 14:00,3,394,27,23,447
12/7/16 15:00,7,424,15,15,461
12/7/16 16:00,4,441,19,24,488
12/7/16 17:00,2,355,20,22,399
12/7/16 18:00,7,379,13,18,417
12/7/16 19:00,8,287,13,20,328
12/7/16 20:00,0,251,10,16,277
12/7/16 21:00,1,231,19,4,255
12/7/16 22:00,0,166,10,21,197
12/7/16 23:00,4,122,11,9,146
13/7/16 0:00,1,99,7,10,117
13/7/16 1:00,0,54,10,6,70
13/7/16 2:00,0,42,8,6,56
13/7/16 3:00,1,42,6,5,54
13/7/16 4:00,0,48,12,7,67
13/7/16 5:00,0,108,16,5,129
13/7/16 6:00,0,140,16,18,174
13/7/16 7:00,0,263,29,12,304
13/7/16 8:00,1,344,22,18,385
13/7/16 9:00,2,416,19,15,452
13/7/16 10:00,3,482,13,16,514
13/7/16 11:00,9,504,15,21,549
13/7/16 12:00,9,597,25,18,649
13/7/16 13:00,7,509,21,28,565
13/7/16 14:00,5,494,14,25,538
13/7/16 15:00,3,449,24,13,489
13/7/16 16:00,7,429,24,31,491
13/7/16 17:00,8,416,14,12,450
13/7/16 18:00,2,390,15,14,421
13/7/16 19:00,9,311,10,13,343
13/7/16 20:00,1,293,15,13,322
13/7/16 21:00,6,234,13,13,266
13/7/16 22:00,1,190,7,14,212
13/7/16 23:00,2,133,6,19,160
14/7/16 0:00,1,106,7,14,128
14/7/16 1:00,0,63,10,11,84
14/7/16 2:00,0,61,11,12,84
14/7/16 3:00,0,52,10,8,70
14/7/16 4:00,0,47,3,4,54
14/7/16 5:00,1,59,8,13,81
14/7/16 6:00,0,138,16,14,168
14/7/16 7:00,1,283,11,15,310
14/7/16 8:00,4,333,17,16,370
14/7/16 9:00,3,478,20,10,511
14/7/16 10:00,6,547,14,16,583
14/7/16 11:00,15,614,19,16,664
14/7/16 12:00,5,817,25,31,878
14/7/16 13:00,10,749,25,27,811
14/7/16 14:00,12,669,14,30,725
14/7/16 15:00,5,641,19,28,693
14/7/16 16:00,8,549,17,18,592
14/7/16 17:00,7,678,21,19,725
14/7/16 18:00,15,669,20,23,727
14/7/16 19:00,11,535,17,16,579
14/7/16 20:00,8,492,15,10,525
14/7/16 21:00,7,343,11,10,371
14/7/16 22:00,7,261,9,13,290
14/7/16 23:00,2,183,7,6,198
15/7/16 0:00,1,134,15,7,157
15/7/16 1:00,2,121,6,3,132
15/7/16 2:00,0,91,10,6,107
15/7/16 3:00,0,65,10,4,79
15/7/16 4:00,2,61,6,3,72
15/7/16 5:00,2,70,5,7,84
15/7/16 6:00,1,123,6,3,133
15/7/16 7:00,5,225,18,3,251
15/7/16 8:00,5,365,11,16,397
15/7/16 9:00,9,519,15,12,555
15/7/16 10:00,6,637,20,8,671
15/7/16 11:00,21,753,6,11,791
15/7/16 12:00,10,798,18,10,836
15/7/16 13:00,19,758,13,13,803
15/7/16 14:00,18,689,15,5,727
15/7/16 15:00,11,622,21,11,665
15/7/16 16:00,15,626,18,12,671
15/7/16 17:00,10,644,13,8,675
15/7/16 18:00,17,564,23,9,613
15/7/16 19:00,10,564,11,5,590
15/7/16 20:00,20,375,13,4,412
15/7/16 21:00,6,259,10,2,277
15/7/16 22:00,10,207,9,5,231
15/7/16 23:00,8,170,9,2,189
16/7/16 0:00,8,147,12,5,172
16/7/16 1:00,4,136,7,7,154
16/7/16 2:00,3,97,16,7,123
16/7/16 3:00,0,83,11,4,98
16/7/16 4:00,3,67,12,2,84
16/7/16 5:00,0,100,16,1,117
16/7/16 6:00,13,136,11,1,161
16/7/16 7:00,0,201,11,5,217
16/7/16 8:00,2,313,8,2,325
16/7/16 9:00,9,473,16,4,502
16/7/16 10:00,9,620,18,0,647
16/7/16 11:00,11,726,15,12,764
16/7/16 12:00,27,817,12,15,871
16/7/16 13:00,23,706,19,12,760
16/7/16 14:00,8,642,17,17,684
16/7/16 15:00,16,589,15,14,634
16/7/16 16:00,13,630,12,16,671
16/7/16 17:00,16,702,16,13,747
16/7/16 18:00,27,728,15,18,788
16/7/16 19:00,13,741,16,23,793
16/7/16 20:00,3,689,14,11,717
16/7/16 21:00,12,515,17,12,556
16/7/16 22:00,5,345,13,10,373
16/7/16 23:00,5,311,6,18,340
17/7/16 0:00,3,134,10,14,161
17/7/16 1:00,0,120,19,9,148
17/7/16 2:00,1,80,16,8,105
17/7/16 3:00,2,63,12,5,82
17/7/16 4:00,1,79,13,4,97
17/7/16 5:00,1,113,14,7,135
17/7/16 6:00,2,254,17,5,278
17/7/16 7:00,5,461,18,16,500
17/7/16 8:00,7,458,17,22,504
17/7/16 9:00,4,476,24,15,519
17/7/16 10:00,3,559,27,23,612
17/7/16 11:00,5,630,19,18,672
17/7/16 12:00,3,581,24,31,639
17/7/16 13:00,5,507,14,25,551
17/7/16 14:00,5,503,24,17,549
17/7/16 15:00,7,481,18,10,516
17/7/16 16:00,8,424,15,19,466
17/7/16 17:00,2,417,16,15,450
17/7/16 18:00,4,431,16,19,470
17/7/16 19:00,8,352,14,15,389
17/7/16 20:00,2,291,14,20,327
17/7/16 21:00,4,255,15,13,287
17/7/16 22:00,1,179,15,8,203
17/7/16 23:00,0,131,8,8,147
18/7/16 0:00,1,85,12,9,107
18/7/16 1:00,2,78,11,4,95
18/7/16 2:00,0,51,10,7,68
18/7/16 3:00,0,32,7,6,45
18/7/16 4:00,0,33,11,10,54
18/7/16 5:00,0,72,5,7,84
18/7/16 6:00,0,147,15,14,176
18/7/16 7:00,2,211,16,18,247
18/7/16 8:00,1,312,17,20,350
18/7/16 9:00,0,442,25,12,479
18/7/16 10:00,1,493,24,23,541
18/7/16 11:00,3,452,20,28,503
18/7/16 12:00,8,489,18,20,535
18/7/16 13:00,1,462,15,25,503
18/7/16 14:00,1,372,20,24,417
18/7/16 15:00,1,380,11,29,421
18/7/16 16:00,7,366,21,14,408
18/7/16 17:00,2,427,20,17,466
18/7/16 18:00,9,418,19,17,463
18/7/16 19:00,6,468,17,15,506
18/7/16 20:00,1,263,15,6,285
18/7/16 21:00,5,247,14,14,280
18/7/16 22:00,1,168,8,10,187
18/7/16 23:00,1,116,9,21,147
19/7/16 0:00,0,93,11,11,115
19/7/16 1:00,1,81,11,2,95
19/7/16 2:00,0,49,11,3,63
19/7/16 3:00,0,39,14,1,54
19/7/16 4:00,0,49,9,2,60
19/7/16 5:00,2,60,10,16,88
19/7/16 6:00,0,147,13,5,165
19/7/16 7:00,3,312,17,15,347
19/7/16 8:00,4,399,10,17,430
19/7/16 9:00,3,394,9,14,420
19/7/16 10:00,1,470,25,24,520
19/7/16 11:00,5,476,22,19,522
19/7/16 12:00,3,595,28,31,657
19/7/16 13:00,4,453,17,29,503
19/7/16 14:00,4,441,11,28,484
19/7/16 15:00,5,436,17,20,478
19/7/16 16:00,3,431,28,17,479
19/7/16 17:00,3,432,15,15,465
19/7/16 18:00,2,433,20,15,470
19/7/16 19:00,2,320,13,20,355
19/7/16 20:00,4,243,11,17,275
19/7/16 21:00,1,237,23,15,276
19/7/16 22:00,1,183,19,10,213
19/7/16 23:00,2,104,6,15,127
20/7/16 0:00,1,92,6,6,105
20/7/16 1:00,0,66,16,11,93
20/7/16 2:00,0,52,15,11,78
20/7/16 3:00,0,41,5,10,56
20/7/16 4:00,0,55,17,8,80
20/7/16 5:00,1,81,11,10,103
20/7/16 6:00,0,151,21,15,187
20/7/16 7:00,1,238,17,21,277
20/7/16 8:00,5,388,27,16,436
20/7/16 9:00,1,446,24,28,499
20/7/16 10:00,5,482,20,19,526
20/7/16 11:00,5,618,18,27,668
20/7/16 12:00,9,602,18,41,670
20/7/16 13:00,2,463,21,36,522
20/7/16 14:00,6,466,24,26,522
20/7/16 15:00,0,416,15,20,451
20/7/16 16:00,7,417,17,18,459
20/7/16 17:00,3,425,24,15,467
20/7/16 18:00,1,367,12,9,389
20/7/16 19:00,1,350,10,16,377
20/7/16 20:00,2,334,12,12,360
20/7/16 21:00,2,263,17,17,299
20/7/16 22:00,0,190,13,11,214
20/7/16 23:00,0,154,16,18,188
21/7/16 0:00,0,118,5,8,131
21/7/16 1:00,1,68,6,7,82
21/7/16 2:00,0,62,13,5,80
21/7/16 3:00,0,42,12,3,57
21/7/16 4:00,0,53,13,7,73
21/7/16 5:00,0,72,13,10,95
21/7/16 6:00,0,148,15,22,185
21/7/16 7:00,3,253,25,18,299
21/7/16 8:00,4,336,12,16,368
21/7/16 9:00,2,445,22,12,481
21/7/16 10:00,1,524,22,22,569
21/7/16 11:00,7,691,25,19,742
21/7/16 12:00,7,757,19,34,817
21/7/16 13:00,4,725,19,36,784
21/7/16 14:00,4,625,23,33,685
21/7/16 15:00,9,619,13,16,657
21/7/16 16:00,5,608,20,19,652
21/7/16 17:00,4,603,15,16,638
21/7/16 18:00,7,612,17,17,653
21/7/16 19:00,6,531,17,12,566
21/7/16 20:00,8,415,14,8,445
21/7/16 21:00,3,296,11,8,318
21/7/16 22:00,3,262,8,6,279
21/7/16 23:00,1,181,13,7,202
22/7/16 0:00,3,151,13,9,176
22/7/16 1:00,3,98,8,4,113
22/7/16 2:00,0,86,14,7,107
22/7/16 3:00,0,66,9,3,78
22/7/16 4:00,0,94,12,5,111
22/7/16 5:00,1,95,9,4,109
22/7/16 6:00,2,156,13,3,174
22/7/16 7:00,3,277,12,9,301
22/7/16 8:00,6,333,11,7,357
22/7/16 9:00,8,461,13,15,497
22/7/16 10:00,7,634,21,13,675
22/7/16 11:00,7,835,16,14,872
22/7/16 12:00,6,818,17,15,856
22/7/16 13:00,3,794,14,19,830
22/7/16 14:00,5,653,15,18,691
22/7/16 15:00,14,668,12,13,707
22/7/16 16:00,2,555,13,12,582
22/7/16 17:00,6,528,13,4,551
22/7/16 18:00,1,469,12,14,496
22/7/16 19:00,6,436,9,6,457
22/7/16 20:00,3,341,7,8,359
22/7/16 21:00,1,247,9,3,260
22/7/16 22:00,1,174,4,4,183
22/7/16 23:00,0,166,14,6,186
23/7/16 0:00,3,140,6,3,152
23/7/16 1:00,0,143,7,2,152
23/7/16 2:00,4,109,3,3,119
23/7/16 3:00,0,84,8,3,95
23/7/16 4:00,0,79,11,0,90
23/7/16 5:00,1,115,12,1,129
23/7/16 6:00,0,234,9,3,246
23/7/16 7:00,5,270,4,4,283
23/7/16 8:00,9,354,11,5,379
23/7/16 9:00,4,438,15,6,463
23/7/16 10:00,7,651,13,14,685
23/7/16 11:00,6,771,11,4,792
23/7/16 12:00,9,826,16,18,869
23/7/16 13:00,7,666,13,19,705
23/7/16 14:00,9,673,8,16,706
23/7/16 15:00,7,602,13,9,631
23/7/16 16:00,10,733,10,5,758
23/7/16 17:00,10,683,15,12,720
23/7/16 18:00,9,697,16,15,737
23/7/16 19:00,4,759,8,11,782
23/7/16 20:00,8,637,15,10,670
23/7/16 21:00,10,474,15,11,510
23/7/16 22:00,3,344,7,18,372
23/7/16 23:00,3,327,13,8,351
24/7/16 0:00,1,162,11,7,181
24/7/16 1:00,1,104,8,9,122
24/7/16 2:00,0,76,13,7,96
24/7/16 3:00,0,74,13,5,92
24/7/16 4:00,1,69,9,5,84
24/7/16 5:00,0,108,13,15,136
24/7/16 6:00,4,238,6,21,269
24/7/16 7:00,3,390,19,14,426
24/7/16 8:00,1,471,11,7,490
24/7/16 9:00,2,565,24,13,604
24/7/16 10:00,4,598,20,22,644
24/7/16 11:00,9,572,22,31,634
24/7/16 12:00,5,653,8,13,679
24/7/16 13:00,7,587,16,24,634
24/7/16 14:00,2,556,11,12,581
24/7/16 15:00,11,496,18,30,555
24/7/16 16:00,8,489,16,20,533
24/7/16 17:00,7,489,13,16,525
24/7/16 18:00,0,405,15,12,432
24/7/16 19:00,1,315,11,19,346
24/7/16 20:00,4,338,9,9,360
24/7/16 21:00,4,254,10,15,283
24/7/16 22:00,1,182,9,17,209
24/7/16 23:00,1,138,8,9,156
25/7/16 0:00,1,81,11,10,103
25/7/16 1:00,0,80,14,12,106
25/7/16 2:00,0,45,5,6,56
25/7/16 3:00,0,44,10,5,59
25/7/16 4:00,0,53,9,7,69
25/7/16 5:00,0,62,12,13,87
25/7/16 6:00,2,125,18,17,162
25/7/16 7:00,2,223,13,14,252
25/7/16 8:00,1,355,19,14,389
25/7/16 9:00,1,398,12,19,430
25/7/16 10:00,5,519,17,17,558
25/7/16 11:00,3,520,14,17,554
25/7/16 12:00,6,582,21,26,635
25/7/16 13:00,6,461,20,29,516
25/7/16 14:00,3,401,19,32,455
25/7/16 15:00,7,393,11,18,429
25/7/16 16:00,7,385,11,17,420
25/7/16 17:00,4,425,13,18,460
25/7/16 18:00,7,436,19,12,474
25/7/16 19:00,5,351,17,17,390
25/7/16 20:00,2,311,16,15,344
25/7/16 21:00,3,242,14,19,278
25/7/16 22:00,4,205,9,16,234
25/7/16 23:00,1,143,11,12,167
26/7/16 0:00,2,179,9,15,205
26/7/16 1:00,1,95,9,13,118
26/7/16 2:00,1,50,7,8,66
26/7/16 3:00,0,60,7,9,76
26/7/16 4:00,0,66,12,9,87
26/7/16 5:00,0,82,14,8,104
26/7/16 6:00,3,207,19,24,253
26/7/16 7:00,8,370,22,14,414
26/7/16 8:00,3,374,19,12,408
26/7/16 9:00,5,498,14,25,542
26/7/16 10:00,6,493,14,23,536
26/7/16 11:00,3,598,15,23,639
26/7/16 12:00,4,611,19,31,665
26/7/16 13:00,3,474,20,32,529
26/7/16 14:00,3,493,18,22,536
26/7/16 15:00,6,445,19,28,498
26/7/16 16:00,5,478,17,19,519
26/7/16 17:00,2,415,17,10,444
26/7/16 18:00,1,348,17,18,384
26/7/16 19:00,7,344,11,17,379
26/7/16 20:00,5,257,10,11,283
26/7/16 21:00,1,245,17,17,280
26/7/16 22:00,1,184,10,8,203
26/7/16 23:00,1,124,9,26,160
27/7/16 0:00,0,95,11,3,109
27/7/16 1:00,0,71,6,5,82
27/7/16 2:00,1,47,7,10,65
27/7/16 3:00,0,54,5,8,67
27/7/16 4:00,0,60,9,11,80
27/7/16 5:00,2,103,3,9,117
27/7/16 6:00,0,154,12,25,191
27/7/16 7:00,4,277,18,12,311
27/7/16 8:00,2,359,16,16,393
27/7/16 9:00,4,487,16,16,523
27/7/16 10:00,7,564,18,16,605
27/7/16 11:00,9,621,20,37,687
27/7/16 12:00,3,662,19,26,710
27/7/16 13:00,5,563,16,31,615
27/7/16 14:00,3,479,23,25,530
27/7/16 15:00,7,465,11,22,505
27/7/16 16:00,5,460,24,24,513
27/7/16 17:00,8,470,16,25,519
27/7/16 18:00,10,490,19,18,537
27/7/16 19:00,7,427,13,15,462
27/7/16 20:00,11,385,10,23,429
27/7/16 21:00,4,287,19,10,320
27/7/16 22:00,5,207,6,13,231
27/7/16 23:00,2,162,17,11,192
28/7/16 0:00,0,121,13,18,152
28/7/16 1:00,0,94,4,4,102
28/7/16 2:00,0,82,11,10,103
28/7/16 3:00,0,67,7,3,77
28/7/16 4:00,0,71,10,5,86
28/7/16 5:00,1,91,7,7,106
28/7/16 6:00,0,149,11,15,175
28/7/16 7:00,2,259,14,12,287
28/7/16 8:00,1,397,11,15,424
28/7/16 9:00,7,533,19,17,576
28/7/16 10:00,8,572,17,11,608
28/7/16 11:00,2,664,11,22,699
28/7/16 12:00,8,709,17,26,760
28/7/16 13:00,5,720,19,34,778
28/7/16 14:00,3,607,18,24,652
28/7/16 15:00,4,591,9,22,626
28/7/16 16:00,4,616,22,28,670
28/7/16 17:00,15,784,11,19,829
28/7/16 18:00,10,713,21,17,761
28/7/16 19:00,3,574,10,13,600
28/7/16 20:00,3,518,12,21,554
28/7/16 21:00,1,385,15,7,408
28/7/16 22:00,0,290,8,9,307
28/7/16 23:00,4,166,13,7,190
29/7/16 0:00,1,139,7,4,151
29/7/16 1:00,0,137,12,6,155
29/7/16 2:00,2,97,6,2,107
29/7/16 3:00,1,61,10,5,77
29/7/16 4:00,0,97,8,2,107
29/7/16 5:00,1,130,5,3,139
29/7/16 6:00,2,210,10,8,230
29/7/16 7:00,5,308,17,10,340
29/7/16 8:00,8,477,16,10,511
29/7/16 9:00,4,580,13,21,618
29/7/16 10:00,7,750,13,16,786
29/7/16 11:00,10,857,14,16,897
29/7/16 12:00,13,997,20,10,1040
29/7/16 13:00,12,897,16,7,932
29/7/16 14:00,6,739,15,17,777
29/7/16 15:00,11,748,9,19,787
29/7/16 16:00,9,689,16,11,725
29/7/16 17:00,10,749,14,13,786
29/7/16 18:00,8,737,14,8,767
29/7/16 19:00,2,490,13,6,511
29/7/16 20:00,8,409,10,6,433
29/7/16 21:00,12,498,9,5,524
29/7/16 22:00,0,281,6,5,292
29/7/16 23:00,0,192,10,6,208
30/7/16 0:00,1,182,7,3,193
30/7/16 1:00,3,160,8,2,173
30/7/16 2:00,0,120,2,4,126
30/7/16 3:00,0,81,7,3,91
30/7/16 4:00,1,98,11,6,116
30/7/16 5:00,0,107,4,4,115
30/7/16 6:00,1,173,12,7,193
30/7/16 7:00,2,261,5,12,280
30/7/16 8:00,5,369,10,10,394
30/7/16 9:00,4,468,13,9,494
30/7/16 10:00,4,634,16,6,660
30/7/16 11:00,13,760,8,20,801
30/7/16 12:00,7,917,18,20,962
30/7/16 13:00,6,766,16,14,802
30/7/16 14:00,7,738,15,9,769
30/7/16 15:00,9,815,13,10,847
30/7/16 16:00,9,796,11,10,826
30/7/16 17:00,6,817,16,16,855
30/7/16 18:00,10,817,17,17,861
30/7/16 19:00,12,782,8,13,815
30/7/16 20:00,18,655,8,16,697
30/7/16 21:00,4,535,13,6,558
30/7/16 22:00,3,324,14,6,347
30/7/16 23:00,2,301,11,14,328
